#########################################################
#########################################################
## 0 # # # # # # # . . . . . . . . . . # # # # . # . # ##
## . # . . . . . . . # # # # # . # # # # # # # . . . . ##
## . # # . # # . # # # # . . # . # . . . . . # . # # . ##
## . . . . . . . . . . . . # # # # . # # # . # . # # . ##
## # # # . # . # . # # # # # . # # . # # # . # . . # . ##
## # # # . # . # # # # . . . . . . . # # . . # # . # . ##
## # # # . # # . . . . . # # # # # # # # . # # # . # . ##
## # . # . # # . # # # # # # . . . . # # . . . . . # . ##
## # . # . . . . # . . . . . . # # # # # # # # # . . . ##
## # . # # # # . # # # . # # # # . . . . . . # # . # # ##
## # . . . # . . # # # . # # # # . # # # . # # # . . . ##
## # . # # . . # # . . . . . . . . # # # . # # # # # . ##
## # . # . . # # # . # # . # # # # # # # . . . . . # . ##
## . . . . # # # # # # # . . . . . # # . . # # # # # . ##
## # . # . . . . . . . . . # # # . # # . # # . . . . . ##
## # . # # # # . # # # # # # # # . # # . . . . # . # . ##
## # # # # # # . . . . . . . # # # # # # # # # # . . 1 ##
#########################################################
#########################################################
