# # # # # # # # # # # # # # # # # # # # # # # # # # # #
# # # # # # # # # # # # # # # # # # # # # # # # # # # #
# # # . . . # # # # # # # # # # # # # # # # # . . . . #
# . . . # . # . . . . . . . . . . . . . . . # . # # . #
# # # . # # # # . # # # . # # # # # # . # . # . # # # #
# . # . . . . # . # . . . # . . . . # . # . # . . . # #
# . . . # # . # . # . # # # . # # . # . # . # # # . # #
# # # . # # # # 0 # # # . # . # # . # # # . . . # . . #
# . . . . . . . . . # # . # . # # . # . # # # . . . # #
# # # . # # # # . # # . . # . . # . # . . . . . # . # #
# # # . # . # # # # 1 . # # # . # . # # # . # . # . # #
# . . . . . . . . # # . # . # . # . . . # . # . # . . #
# . # # # # # # . . # . # . # . # # # . # . # . # # . #
# . # . . . . # # # # . # . # . # # # . # . # . # # . #
# # # . # # . # # . . . # . # . # # # . # # # . # . . #
# . . . # # . # # . # # # . # . # # # . . . . . # . # #
# . # # # # . . . . # # # . # . # # # # # # # # # . . #
# . # # # # # # # # # # . . . . # # # . . . # # # # . #
# . . . . . . . . . . . . # # # # . . . # . . . . . . #
# # # # # # # # # # # # # # # # # # # # # # # # # # # #
# # # # # # # # # # # # # # # # # # # # # # # # # # # #
