# # # # # # # # # # # # # # # # # # # # # # # # # # # #
# # # # # # # # # # # # # # # # # # # # # # # # # # # #
# 0 # # # # # # # . . . . . . . . . . # # # # . # . # #
# . # . . . . . . . # # # # # . # # # # # # # . . . . #
# . # # . # # . # # # # . . # . # . . . . . # . # # . #
# . . . . . . . . . . . . # # # # . # # # . # . # # . #
# # # # . # . # . # # # # # . # # . # # # . # . . # . #
# # # # . # . # # # # . . . . . . . # # . . # # . # . #
# # # # . # # . . . . . # # # # # # # # . # # # . # . #
# # . # . # # . # # # # # # . . . . # # . . . . . # . #
# # . # . . . . # . . . . . . # # # # # # # # # . . . #
# # . # # # # . # # # . # # # # . . . . . . # # . # # #
# # . . . # . . # # # . # # # # . # # # . # # # . . . #
# # . # # . . # # . . . . . . . . # # # . # # # # # . #
# # . # . . # # # . # # . # # # # # # # . . . . . # . #
# . . . . # # # # # # # . . . . . # # . . # # # # # . #
# # . # . . . . . . . . . # # # . # # . # # . . . . . #
# # . # # # # . # # # # # # # # . # # . . . . # . # . #
# # # # # # # . . . . . . . # # # # # # # # # # . . 1 #
# # # # # # # # # # # # # # # # # # # # # # # # # # # #
# # # # # # # # # # # # # # # # # # # # # # # # # # # #