# # # # # # # # # # # # # # # # # # # # # # # # # # # #
# # # # # # # # # # # # # # # # # # # # # # # # # # # #
# # # # # . # # # # # . # # # # . . . . # # # . . . . #
# . . . . . . . . . . . # . . . . # . . . . . . # # # #
# # # # # # # # . # # # # . # # # # . # . # # # # 1 # #
# . . # . . . . . . . . . . . # # . . . # # . . # . # #
# . # # # # . # . # . # . # . . # . # . # . . # # . # #
# . # . # . . # # # # # # # # # # # # . # # . . . . # #
# . # . # # . . . . . . . . . . . . # . . # # # # . # #
# . # . # . . # # # # # # # # # # . # # . . . . # . # #
# . # . # # . # # . . . . # # . # . . # # # # # # . # #
# . # . # . . # # . # # . # . . . . # # . . . . . . # #
# . # . # # . # # . # # . # . # # # # # . # # # # # # #
# . # . . . . # # . # # . # . # . # . . . . . # # # # #
# . # # # # . . . . # # . # . # . # . # # # . # . . . #
# . . . . . . # . # # # . # . # . # # # # # . # . # # #
# # # # 0 # . # . # . . . # . . . . . . . . . # . . . #
# # . # # # . # . # . # # # # # # # # # # # # # # # . #
# . . . . . . . . # . . . . . . . . . . . . . . . . . #
# # # # # # # # # # # # # # # # # # # # # # # # # # # #
# # # # # # # # # # # # # # # # # # # # # # # # # # # #
