
#########################################################################################################################################################################################################
#0..........................#...................................................................................................................................#.......................................#
###.###.#############.#####.###.###...#######.###...#############.###.###.###.###.#####.#######.###.###.#####.#.#########.#.###.#######.###.###.###.#.#######...#.###.#####.#####...###.#####.#.#####.#.#
#.#.#.#.#.#.........#.....#...#...#...#.....#.#.#...#...#.......#.#.#.#.#.#.#.#.#.#...#.#.....#...#.#.#.#...#.#.#.....#.#.#.#.#.#.....#.#...#.#...#.#.#.#...#...#.#.#.#...#.#...#...#.#.#.....#.#.....#.#
#.###.#.#.#.###.###.###.#####.#####.###.###.###.###.#.###.#####.###.###.#.#.###.###.###.###.###.#.#.#.#.###.#.#.###.#.#.#.#.#.#.###.###.###.#.#.###.#.#.#.#.#...###.#.#.#.#.###.#.###.###.#.###.#######.#
#.......#.#.#.#...#...#.#...#.......#...#.#.......#.#.........#.......#.#.#...............#.#...#.#...#.....#.#...#.#...#.....#...#.......#.#.#.#.#.#.#.#.#.#.......#.#.#.#...#...#.......#.#...#.#.....#
#.#####.#.#.#.###.###.#.#.#.#...###.#####.#######.#.#.###.###.###.###.#.#.#...###########.#.#...###.###.#####.#####.#####.###.#.#.###...#####.#.#.#.###.#.#.###.###.###.###.#.###.#.###.###.#####.#.###.#
#.#...#.#...#...#...#.#.#.#.#...#.#.............#.#...#.#.#.#.....#.#.#.#.#...#...........#.#.......#...#.......#.........#.#.#.#...#...#.....#.#.#...#.#.#...#.#...........#...#.#.#.#.#.......#...#.#.#
#.#.###.#.###.#######.#.#.#.#.###.###.#####.#####.###.#.#.#.#.#####.###.#.###.#############.#.......###.#######.###.#.###.#.#.#.#.#.#.#.#.#####.#.#.###.###.###.#.#.###.###.#...###.#.#.#######.###.#.#.#
#.#.#...#.............#.#.#.#.......#.....#.#.....#.#.#.#...#.#...........#.#...............#...........#.....#...#.#.#.#.#.#.#.#.#.#.#.#.#.........#.......#.#.#.#.#.#...#.#.......#.........#...#.#...#
#.#.#####.###########.#.###.###.#####.#####.#.###.#.#.#.#####.#######.###.#.###.###.#####.###.......###.#.###.#.###.#.#.#.#.###.#.#.#.#.#.#.###.#.###.###.###.#.###.#.#######.###.#.#.###.###.#.#.#.###.#
#.#.......#.........#.#.......#.#.....#.....#.#.#...#.#.............#.#.#.....#.#.#.#...#.#.........#.#.#...#.#.#...#.#.#.#.......#.#.#.#.#...#.#.#...#.#.#...#.....#.........#.#.#.#.#...#.#...#.#...#.#
#.#...###.#########.###.#######.#####.#####.#.#.#.###.#.###.###.....###.###...###.###.###.#########.#.#.#.###.###.###.#.#.#.#.#####.#.#.#.###.###.###.#.###...#######.#.#######.#.#.###.###.###.###.###.#
#.#...#...#.............#.........#.#...#.#.#.#.#.#...#.#...#.#...........#...........#...........#.....#.........#...#.#...#.#...#.#...#...#...#...#.#...............#.#.......#.#.....#.#...#.....#...#
#.#####.###.#######.#####.#########.#####.#.###.#.#####.###.#.#.......###.###.#.#####.###.###.###.#####.###.#######.###.###.###.#.#.###.#.#.#.#.#.###.###.....#.#######.###.#####.#.###.#.###.#####.###.#
#.......#...#.....#.#.............#.......#.....#...........#.#.......#.#...#...#...#...#.#.#.#.#.#...#...#.#.............#.....#.#...#.#.#.#.#...#.....#.....#...#.......#.#.....#.#.#.....#.....#...#.#
#.#####.#.###.###.#.#.#########.###.#######.#.###.###########.#####.###.#.#.###.#.###.###.#.###.###.#.#####.#...###.###.#.#.###.###...###.#.#.#####.###.#.###.###.#.#####.#.#####.###.#.###.#####.#.###.#
#.#.#.#.#.#...#.#.#.#.........#.#...........#.#...#...............#.#...#.#...#...#...#.............#.......#...#.#.#.#.#.#.#.#.............#.#.#...#.#...#.#...#.#.#...#.#.....#...#...#.#.....#...#...#
#.#.#.#.#.###.#.#.#.#.###.#######.###.......#####.###.#########.###.###.#.#####.###.###.#########.###.#####.#...#.###.#####.#.###.#####.#####.#.#.###.#####.#.###.#.###.###.###.###.#.###.#.....#####.#.#
#.#.#...#...#.#.#.#.#...#.#.........#...........#...#.#.............#...#...........#...#.......#.#.......#.#...#...........#...#.#.....#.....#...#...#.....#.#...#.#.........#...#.#.#...#.......#...#.#
#.#.#####.###.#.###.###.#.###########.#######.#.###.#.###.###.###.###.###.###########.###...###.#.###.###.#.#.###.#########.###.#.#####.#######.###.###.###.#.#.###.#######.###.###.#.###.#.......###.###
#.#...#...#...#.......#.#...#...............#.#...#.#.....#.#.#.#.#...#...............#.#...#...#.....#.#...#.#...........#...#.#.....#.........#...#.....#.#.#.#.........#.#.#.....#...#...........#...#
#.###.###.###.###.###.###...###.#######.#.###.###.###...###.#.#.###.###############.###.#...###.#####.#.###.###.#.###.###.#####.#####.#####.###.###.#####.#.#.#.#.#######.###.###.#.#.###.#######.###.#.#
#...#...#.#.#...#.#...........#.#...#.#.#.#.............#...#.#.....#...............#...#.....#.....#.....#.......#.#.#.#...........#.....#.#.#...#.....#.#.#.#.#.#...#.........#.#.#.#...#.#...#.....#.#
#.###.#.#.#.#.#.###.###.###.###.###.#.#.###.###.###.....#.#.###.###.#####.###########...#.#####.###.#####.#.#####.#.###.#####.###.###.###.#.#.###.###.#.###.#.###.###.#####.###.#.###.#.###.###.###.###.#
#.#...#.#...#.#.....#.#.#.#.#.....#.#.#.....#...#.#.....#.#.....#.#.....#.#.............#.#.....#.#.....#.#.#...#.#...........#...#.#.....#.#...#...#.#.....#.......#...#...#.#.......#.#.....#...#.....#
#.#####.###.#.###.###.###.#.#.###.#.#.###.#.#####.#####.###.#####.#.#.###.###.###...#####.#.###.#.#####.###.#.###.#.###########.###.#####.#.#.###...###.###.#####.#.#.#.#####.###.###.#.###...###.#####.#
#.........#.#...#.#.........#.#.#.#.#...#.#...........#...........#.#.#.....#...#...#.....#.#...#.....#.......#...#.#...........#.......#.#...#...........#.....#.#.#.#.......#.#.#.#.....#.....#.....#.#
#.#######.#.###.#.#######.###.#.#.#.###.###.#####.#.#.#.#######.###.#.#####.#.#####.#######.#####.###.#.#####.#.###.#.....#####.#.###.###.#.#.#.###############.###.#.#.###.###.#.#.#####.#.###.#.#####.#
#.#.....#.#.....#.......#.#...#...#...#.#...#...#.#.#.#.....#.#.#...#.....#.#.#...#...............#.#...#...#.#.#...#.....#...#.#.#.#.#...#.#.#.#...................#...#...#...#.#.....#.#.#.#...#.....#
#.#.###.#.#.###.###.###.###.###.#.###.#.###.#.###.###.#.###.#.#.###.#.###.###.#.###.###.###.#######.#.###.#.#.###...#.....###.#.###.#.#####.###.#.#####.###########.###.#.###.###.#####.###.#.#####...###
#.#.#.#.#.#.#.#.#.#...#.........#...#.#...#...#.......#.#.#.#.#...#.#.#.#.......#...#.#.#.#.#.......#.#...#.#.......#.......#.#.....#.#.......#...#...#.#.....#...#...#.#.#...#.............#...#.....#.#
#.#.#.###.###.#.#.#############.#####.#.###.###...###.###.#.#.###.#.#.#.###.###.#...#.###.#.###.###.###...#.#######.###...###.#######.#####...#.###.###.#####.###.#.###.#.#.#.#####.#######.###.###.###.#
#...#.........#.#...........#...........#.........#.#.......#...#.#.#.#...#.#.#.#...#.....#...#.#.#...............#...#...#...............#...#.#...........#.....#.#...#.#.#.......#.........#...#.#...#
#.###.#########.###.###########.#.#######.###.....#.#######.###.###.#.###.###.#.###.#.#####.###.#.###.#.#####.###.###.###.#.#####.###.###.###.#.#########.###.###.#.#.#.#.#####.#.###.#####...#.###.###.#
#.#...#.........#.#...........#.#.#.#.......#.....#.......#...#.....#...#.....#...#.#.#.....#...#.#.#.#.#...#.#.#...#...#.#.#.#...#.#.#.#...#.#.........#.#...#.#.#.#.#.#.....#.#.#.......#...#.#.....#.#
#.#.###.#########.#########.###.###.#.###.###.....#####.#.#...###.###.###.###.###.###.#####.#####.#.###.#.#.#.#.#####.###.#.#.###.#.###.###.#.#.###.#.###.#.#.#.###.#.#.#.###.#.#.#########.###.#######.#
#.#.#...#.....#...........#.......#.#.#.#.#.............#.#.....#.#.......#.#...#.........#.......#.....#.#.#.#.......#.#.#.#...#.........#.#.#.....#.#...#.#.#.....#...#.#.#.#.#...........#...........#
#.#.#.#.#.....#.###.#######.#####.#.#.#.#.###.###.###.#####.#####.###.#####.#.#.#.###.#####.#####.#.###.#.#.###.....###.###.###.#.###...###.#.#######.#.#.###.#######...###.#.###.#####...###.#########.#
#.#.#.#.#.....#.#.#.........#...#...#.#.#.....#.#.#.#.#.....#...#...#.#.....#.#.#.#.#.#.........#...#.#.#.#.........#.........#.#.#.#...#...#.......#.#.#...................#.....#...#...#...#.......#.#
#.#.#.#.#.#####.#.#####.###.#.#.###.###.#######.###.#.###.###.###.###.#.....#.#.###.#.#.#########.###.###.###.#####.#.###.###.#.###.#...#####.#.###.###.###.#.#####.###.#.#.#####.###.#####.###...###.#.#
#.#.#.#.#.#...#.#.....#.#.#.#.#...#.................#...#.....#...#.........#.......#.#.......#...#.........#.#...#.#.#.#.#.#.#.#...#.........#.#.#.......#.#.#.#.#.#.#.#.#.....#...........#.....#.#.#.#
#.#.#.###.###.#.###.#.#.#.#.#.###.#.#####.###.###.###...#.#####.###.###...###.###.###.#####.###...###########.#.###.#.#.#.#.###.###.#.###.###.###.#########.###.#.###.#.#.###.###...#####.#.#.###.#.###.#
#.#.#.........#...#.#.#.#.#.#.....#.#...#...#.#...#.....#.#.....#...#.#...#...#.#.#...........................#.....#.#.#.#.........#.....#.#.#...........#.....#.....#.#...#.#.....#...#...#.....#.....#
#.###.###.###.#.###.#.###.###.###.###...#####.#####.....###.....#####.#####.###.###.###.#######.....###.#####.#####.###.###.###.###.#####.#.###.#########.#####.###.###.###.#.#.....###.###.#####.#.###.#
#.....#.#.#.#.#.#...#.#.......#.#...........................................#.......#...#.#...#.....#.#...#.#.#...#.......#...#.#.#.....#.......#.......#.....#.....#...#.#...#.......#...#.#...#.#...#.#
#.#####.#.#.#.#.#.#.#.#.###.###.#.###.###...#########.#####.#######.###.....#.....###.###.###.#######.###.#.#.###.###.###.#####.#.###.#.###.#########.###.###.#.#####.#.#.#####...#####.###.#.###.#####.#
#.#.....#.#.#.#.#.#.#...#.#.#.....#.#.#.#...#.......#.#...#.#.......#.#.....#.....#...#.................#.#.#.....#...#.#.......#...#.#...#.#.......#.....#.#.#.#.....#.#.........#.......#...#.........#
#.#####.#.#.###.#.#.#.###.###.###.#.#.#.#######.###.###.###.###.###.#.#.#####.#######.#.#####.###.###.###.#.#####.###.#.#########.###.#####.###.###.#####.#.###.###...###.###.#.#.###.#####.###.#######.#
#...#...#.#.....#.#.#.#.......#.#...#...........#.#.....#...#...#.#.#.#.#.....#.......#.....#.#.#.#.#.#...#.........#.#...........#.#.....#...#.........#.#...............#.#.#.#...#.#.....#.......#...#
#.#.#.###.#####.#.#.#.#.#####.#.#.###.###.....###.#####.###.#####.###.###.###.#######.#####.###.###.#.#.###.#######.#.#.###.###.###.#.###.###.#.#########.#.#########.###.#.#.#.#.###.###.###.#######.###
#.#.#.#.......#.#.#.#.#.#...#.#.#.#...#.#.....#.......#.#.#.................#.......#.....#.........#.#.#...#.....#.#.#.#...#...#...#...#...#...#.#.....#.#.#.......#...#.#.#.#...#.....#.#...#.......#.#
#.###.#...###.###.#.#.#.###.###.#.#.###.#######.......###.#.#####.#####.#######.###.#.###.#######.###.#.#.###.#####.#.#.#.#.###.#.###.###...#.###.#####.#.#.#.#####.#.#####.#.#.###.#####.#.###.###.###.#
#.....#...#...........#...#.....#.#.#.......#...............#...#.#.#...#.....#.#...#.#.#.#.......#...#...#...#.....#.#.#.#.#.#.#.#.........#.#.......#.#.#.#.#...#.#.#.....#.#.#.........#.#...#.#.#...#
#.###.###.###...#####.#.#.#.#######.#.#####.#.....#####.#####...###.#####.#####.###.###.###.....###.#.#####.#.#####.###.###.#.###.#.#######.#.###.#####.#.#.###.###.#.#.###.#.#.###.#.###.#.#.###.#.#...#
#.#.....#.......#...#.#.#.#.........#.#...#.#...........#.........#.......#.#.....#.............#...#.......#.....#.........#.......#.#...#.#...#.......#.......#...#...#.#...#.#.#.#.#...#.#.#...#.#...#
#.###.###.###...###.#.#.#.###.###.###.#.###.###.#####.###.#####...#.#.###.#.###.###.###.###.....###.#####...#####.###.#####.#.###.###.#.###.###.#######.#.#######.#.#.###.#####.#.###.###.#.#.#...#.###.#
#...#.#...#.#.....#.#.#.#...#.#.#.#.....#.....#.#.....#...#...#...#.#...#.....#.#...#.#.#.#.......#...........#.#...#.#...#.#.#.#.....#.#.....#.......#.#.#.......#.#.#.................#.#.#.#...#...#.#
#.###.###.#.#######.#.#.#####.#.#.#####.#.#####.#.###.#.###.#####.#.###.#####.#.###.#.#.#.#.......###.###.###.#.#.###.###.#.#.#.#####.#.###.###.#####.#.#.#######.#.#.#.#.###############.#.###...###.#.#
#.#...#...#.........#.#...............#.#.#.....#.#.#.#.#...#...#.#...#.....#.#...#...#...#.........#.#.#.#.#.#.#.#.....#...#.#.....#.#...#.#...#.....#.#.......#.#.#.#.#.#.........................#.#.#
#.#.###.###.###.#####.#.###.###.......###.#.#####.#.###.#.###.#.###...###...#.###.###.###.#####.#####.#.###.#.#.#.#.###.###.#.###.###.###.###...#######.#######.###.#.#.###.#######.#.###.###.#####.###.#
#...#.#.#...#.#.#.....#.#.#.#.#...........#...#...#.....#.#...#.........#...#...#...#...#.....#.#.....#.....#.#.#.#...#...#.#.....#...........................#.....#.#.#.........#.#.#.#.#...#.......#.#
###.#.#.###.#.###.###.###.###.#.....#####.###.###.#####.#.#####...###...#...###.###.###.#####.###.....#.#.###.#.#.###.#.#.###.###.#######.###.#####.#.#.#####.#######.#.###...###.#.###.#.#####.#######.#
#.#.#.#...#.......#.#.........#.....#...#...#...#.....#...........#.#.............#...#.#...#.........#.#.#.#.#.#...#.#.#.....#.#.......#.#...#...#.#.#.#...#.........#.#.#...#...#.....#.......#.......#
#.#.#.#.###.#####.#.#####.#####.#######.#####.###.###.#.###.#######.#...###.#####.#.###.###.#.#.#####.###.#.###.#.#.###.#######.#########.###.###.#.#.#.#.#####.#####.#.#.###.###.#.###.#.###.###.#####.#
#.#...#.#.....#.#.#.....#...#.#.#.....#.......#...#.#.#.#.#.#.......#...#...#...#.#.#.......#.#.....#.....#.......#.............#...........#...#.#.#.#.#.....#.#.....#.....#.....#.#...#.#.#.#.......#.#
#.#####.#.#####.#.###.###.###.###.###.#.###.###...#.#.###.#.#.#.#.#.#.###.###.#.#.#.#####.###.###.#.#.....###.#.###.###########.#.#####.#.###.###.#.#.#.#####.#.#.#####.###.###.###.###.###.#.#####...#.#
#.......#.#.....#.........#.......#.#.#.....#.....#.#.....#.#.#.#.#.#.#...#...#.#.#...#.#.#.....#.#.#.......#.#.#...#.#.......#.#.#.....#.#.#.#.....#.#.....#.#.#.#.....#.#...#.#.....#.#.........#...#.#
#.###.###.#.###.#.###.###.###.#.###.###.###.#.###.#.#.#####.###.###.###.###.#.#.#.#.###.#.#####.###.#######.###.#####.###.#####.#.#.#####.#.#######.#.###...#.#.###.#.###.#####.###.###.###.#####.#...#.#
#.#.#.#...#.#.#.#...#.#.#...#.#.#.......#.#.#.#.#.#...........#.........#.#...#.#.#.#...#.....#...........#.........#...#.......#.#.#.............#.#...#...#.........#...........#.#.....#.#...#.#...#.#
#.#.#.#.###.#.#.###.###.#.#.###.#.###.###.###.#.#.###.#######.#.#########.#####.###.###.#####.#.#####.#########.###.#.###.###.#.###.###.#.#####.###.###.###.#.###.###.#######.#####.###.###.#.###.#.###.#
#.#.#.#.#.....#...#.....#.#.....#.#.#.#.#.......#...#.#.....#.#.#.#...................#.....#.#.#.#...#.......#.#.#.#.....#.#.#.......#.#.#...#.#.....#...#.#.....#.#.......#.#.....#.#.#.#.#.#...#.#.#.#
#.#.#.#.#####.###.###.#.###.#####.#.#.#.#.#####.#####.###.#.###.#.###########.#######.###.###.#.#.#.###.#.###.#.#.#.###.###.#######.#.###.###.#.###...#####.#.#####.#.#####.#.#######.#.#.#.#.#####.#.#.#
#.#.#.......#...#...#.#.....#.....#.#...#.#...#...#.#...#.#.....#...........#.#.....#...#.#...#.#...#...#.#.#...#.#...#.#.........#.#.........#...#.......#.#.#.....#.#...#.#.........#...#.#.........#.#
#.#.#######.###.###.###.#####.#####.#####.###.#####.#.#.#.###.###...#####.###.#.###.#####.#.###.#.###.#####.###.#.###.#.#.#.#######.###.#####.###.#...###.###.#####.#.#.###.###.....###.###.###.#####.#.#
#.#.......#...#...#...#.#.........#.........#.......#.#.#...#.#.....#...#.#...#.#.#.......#.#...#.#.............#.....#.#.#.#.........#.#...#...#.#...#.#.........#...#.#.....#.....#...#.......#...#.#.#
#.#######.#.#.###.#.#.#.###.###.#.#.#######.#.#####.#.#.###.#.#######.###.###.#.#.#.###.#.###...#.#.#.#######...#######.#.###.#########.###.#####.#...#.###.#####.#.###.#.#####...###.###.#####.###.###.#
#.....#.#.#.#.#.#.#.#.#...#...#.#.#.......#.#.#.#.#.#.#...#.#.................#...#.#.#.#.........#.#.#.....#...........#.....#.......#...#.......#...#.....#...#.#.#...#.#.......#...#...#...#.......#.#
#.#.#.#.#.#.###.#.###.#####.###.#.#####.###.#.#.#.#.#.#.###.###.#######.#####.#####.#.#####.#####.#.#.#.###.#####.#####.#.###.###.###.###.###.#.#.###.#####.#.#.###.###.#.#####...#####.###.###.#####.#.#
#.#.#.#.#.#...#.....#.....#.#.......#.#.#.#.#.#...#.#.#.#.....#.#.....#.....#.......#.....#.......#.#.#.#.#.....#.....#.#...#...............#.#.#...#.....#.#.#.........#.....#.........#...#.....#.#.#.#
#.###.#.#.#####.#####.#####.###.###.#.###.#.###.###.#.#.#####.###.#.###.###.#.#######...###...###.#.###.#.###.#.###.###.###.#####.#########.#.#.###.#####.#.###.#####.###.#####.#########.###...###.###.#
#.......#.......#.....#.......#.#.#.#...........#...#.#.....#.....#.#.#.#.#...#.....#...#.....#...#.#.#.#...#.#...#.#.#.........#.#.......#.#.#.#.#.#...#...#.#.....#.#...#.....#.........#.....#.......#
#.#######.#.###.###...###.#####.#.###.###.#####.#...#.###.#.#####.###.###.###.#####.#.###.....###.###.#.###.#.###.#.#.###.#####.###.###.###.#.###.###...###.#.#####.#.#####.#####.....#####.###.#.#####.#
#.#.......#.#.#...#.....#.#.....#.....#.#.#...#.#...#...#.#.#...#...........#.....#.#.#.........#.....#.....#.#.#.#.#...#.#.........#.#.#...#.............#.#.....#.#.......#.........#.....#.#.#.....#.#
#.#.#######.#.###.###.###.#######.....#.#.#.###.###.###.#.#####.#######.#####...###.#.#.#######.###...#######.#.#.###.#.###.#########.#.###.#.#####.#####.#.#####.###.###.#####.#####.#######.#.#####.#.#
#.#.#.......#...#...#.#...............#.#.#.#...#.#...#.#.............#.#.......#...#...#.....#...#...........#.#.....#...#.#.........#...#.#.#...#.....#.#...........#.#.#.....#...#.........#.....#.#.#
#.#.###.#####.#.#.###.#.#####.###.###.#.###.#.###.###.#.###.#########.#.###.#.#.#.#.#####.#####.#.#.#########.#.#.###.#.###.#.###.#####...#.###.#########.#.###.#######.#.###.###.###.#####.#.#.#####.#.#
#.#.........#.#...#.....#...#.#.#.#.#.#.....#.#.....#.#...#.#.........#...#.#.#.#.#.......#.....#.#...........#.#.#.#.#.#...#...#.#.......#.....#.........#.#.#.#...........#.#...#...#...#.#.#.#.#...#.#
#.#######...###.#.###.###.#.#.#.###.#.###.#.#.#.###.#.###.###.#########.###.###.#.#.#######.###.###.#######.###.###.#.#.#...###.#.###.###.#.###.#########.#.#.#.#.#########.###.#.###.#.###.#.#.#.###.#.#
#...#...#.......#...#.#...#.#.#.....#...#.#.#.....#.#.........#.....#...#.......#.#.#.......#.#.....#.....#.#.......#.#.#.....#.....#.#.#.#.#...........#...#.#.#.#.......#...#.#.....#.#...#.#.....#.#.#
#.#.###.#.#####.#.###.#.#####.#####.#...#.#########.#...###...#####.#####.#####.###.#####.###.#####.#.#####.#.....###.#.#####.#####.#.#.#.###.###.###...###.#.#.#.#######.###.###.###.#.#####.#####.#.#.#
#.#...#...#...#.#.#...#...........#.#...#...........#...#.#.......#.......#...#.........#.#.......#.#.#.....#.....#...#.....#.....#.#.#.#...#.#.#.#.#.....#.#...#.......#...#.....#.#.#.....#.....#.#.#.#
#.#.###.###.###.#####.#######...###.#####.#########.###.#.#...###.#.###...###.#####.#####.###.###.#.#.#...###.#####.###.###.#.#####.###.###.###.#.#.#####.#.###########.#.###.#####.#.#.....#####.###.#.#
#...#...#...#.......#.......#...#.........#.......#...#...#...#.#.#...#.....#.....#...#.....#.....#.#.#...#...#.....#...#.#.#.#...........#.....#.#.#...#.#...........#.#.....#.....#.#.........#.....#.#
#.###.###.###.#####.#.#####.###.###########.#.#.###.###.#####.#.#.#####.....###.###.#.#####.###.###.#.#...#.#.#.###.###.#.###.###########.#.###.#.#.#.###.#.#####.#.###.###.#.#.###.###.###.#####.###.#.#
#.#...#.........#.#.#.#...#...#.........#...#.#.#...#...#...#.#.#.............#.#...#.....#...#.#...#.....#.#.#.#.....#.#.................#.#.#.#.#.#.#...#.....#.#.#.....#...#...#...#.#.#.#.....#...#.#
#.#####.#.#######.#.#.#.###.#.#.###.###.###.#.#.#.###.#.#.#.###.###########...#.#.#.#######.###.###.###.###.#.#.#.###.###.###.#######.###.###.#.#.#.#.###.###...###.###.#####.#######.#.#.###.###.###.#.#
#.......#.#.......#...#.#.#.#.#.#.#.#.#...#.#.#.#.#...#.#.#...............#...#.#.#.........#...........#.....#.#.#.#.....#.#...#.#.#.#.#.....#.#...#...#...#...#...#.#.....#.#.....#.#.......#.#...#.#.#
#.......###.###########.#.###.###.###.#####.###.#######.#.#####.#########.#####.###.........#############.###.###.#.#######.#####.#.###.#######.#####...#####...#####.#####.###.#####.#########.#...###.#
#.......................................................#.....#.#...........................................#.....#.............................................................................#......1#
#########################################################################################################################################################################################################