# # # # # # # # # # # # # # # # # # # # # # # # # # # # # #
# # # # # # # # # # # # # # # # # # # # # # # # # # # # # #
# # 0 # # # # # # # . . . . . . . . . . # # # # . # . # # #
# # . # . . . . . . . # # # # # . # # # # # # # . . . . # #
# # . # # . # # . # # # # . . # . # . . . . . # . # # . # #
# # . . . . . . . . . . . . # # # # . # # # . # . # # . # #
# # # # # . # . # . # # # # # . # # . # # # . # . . # . # #
# # # # # . # . # # # # . . . . . . . # # . . # # . # . # #
# # # # # . # # . . . . . # # # # # # # # . # # # . # . # #
# # # . # . # # . # # # # # # . . . . # # . . . . . # . # #
# # # . # . . . . # . . . . . . # # # # # # # # # . . . # #
# # # . # # # # . # # # . # # # # . . . . . . # # . # # # #
# # # . . . # . . # # # . # # # # . # # # . # # # . . . # #
# # # . # # . . # # . . . . . . . . # # # . # # # # # . # #
# # # . # . . # # # . # # . # # # # # # # . . . . . # . # #
# # . . . . # # # # # # # . . . . . # # . . # # # # # . # #
# # # . # . . . . . . . . . # # # . # # . # # . . . . . # #
# # # . # # # # . # # # # # # # # . # # . . . . # . # . # #
# # # # # # # # . . . . . . . # # # # # # # # # # . . 1 # #
# # # # # # # # # # # # # # # # # # # # # # # # # # # # # #
# # # # # # # # # # # # # # # # # # # # # # # # # # # # # #
