# # # # # # # # # # # # # # # # # # # # # # # # # # # # # # # # # # # # # # # # # # # # # # # # # # # # # # # # # # # # # # # # # # # # # # # # # # # # # # # # # # # # # # # # # # # # # # # # # # # # # # # # # # # # # # # # # # # # # # # # # # # # # # # # # # # # # # # # # # # # # # # # # # #
# # # # # # # # # # # # # # # # # # # # # # # # # # # # # # # # # # # # # # # # # # # # # # # # # # # # # # # # # # # # # # # # # # # # # # # # # # # # # # # # # # # # # # # # # # # # # # # # # # # # # # # # # # # # # # # # # # # # # # # # # # # # # # # # # # # # # # # # # # # # # # # # # # #
. . . . . . . . . . . . . . . . . . . . . . . . . . . . . . . . . . # # # # # # # # # # # # # # # # # # # # # # # # # # # # # # # # # # # # # # # # # # # # # # # # # # # # # # # # # # # # # # # # # # # # # # # # # # # # # # # . . . . . . . . . . . . . . . . . . . . . . . . . . . . . . . .
. . . . . . . . . . . . . . . . . . . . . . . . . . . . . . . . . . . . . . . . . . . . . . . . . . . . . . . . . . . . . . . . . . . . . . . . . . . . . . . . . . . . . . . . . . . . . . . . . . . . . . . . . . . . . . . . . # . . . . . . . . . . . . . . . . . . . . . . . . . . . . . . . . .
. . . . . . . . . . . . . . . . . . . . . . . . . . . . . . . . # . . . . . . . . . . . . . . . . . . . . . . . . . . . . . . . . . . . . . . . . . . . . . . . . . . . . . . . . . . . . . . . . . . . . . . . . . . . . . . . . . # . . . . . . . . . . . . . . . . . . . . . . . . . . . . . . . .
. . . . . . . . . . . . . . . . . . . . . . . . . . . . . . . # . . . . . . . . . # # # # # # # # # # # # # # # # # # # # # # # # # # # # # # # # # # # # # # # # # # # # # # # # # # # # # # # # # # # # # # # # # . . . . . . . . . # . . . . . . . . . . . . . . . . . . . . . . . . . . . . . . .
. . . . . . . . . . . . . . . . . . . . . . . . . . . . . . # . . . . . . . . . # . . . . . . . . . . . . . . . . . . . . . . . . . . . . . . . . . . . . . . . . . . . . . . . . . . . . . . . . . . . . . . . . . # . . . . . . . . . # . . . . . . . . . . . . . . . . . . . . . . . . . . . . . .
. . . . . . . . . . . . . . . . . . . . . . . . . . . . . # . . . . . . . . . # . . . . . . . . . . . . . . . . . . . . . . . . . . . . . . . . . . . . . . . . . . . . . . . . . . . . . . . . . . . . . . . . . . . # . . . . . . . . . # . . . . . . . . . . . . . . . . . . . . . . . . . . . . .
. . . . . . . . . . . . . . . . . . . . . . . . . . . . # . . . . . . . . . # . . . . . . # # # # # # # # . # # # # # # # # # # # # # # # # # # # # # # # # # # # # # # # # # # # # # # # # # # # # # # # # . . . . . . # . . . . . . . . . # . . . . . . . . . . . . . . . . . . . . . . . . . . . .
. . . . . . . . . . . . . . . . . . . . . . . . . . . # . . . . . . . . . . . . . . . . # . . . . . . . . . . . . . . . . . . . . . . . . . . . . . . . . . . . . . . . . . . . . . . . . . . . . . . . . . # . . . . . . # . . . . . . . . . # . . . . . . . . . . . . . . . . . . . . . . . . . . .
. . . . . . . . . . . . . . . . . . . . . . . . . . # . . . . . . . . . # . . . . . . # . . . . . . . . . . . . . . . . . . . . . . . . . . . . . . . . . . . . . . . . . . . . . . . . . . . . . . . . . . . # . . . . . . # . . . . . . . . . # . . . . . . . . . . . . . . . . . . . . . . . . . .
. . . . . . . . . . . . . . . . . . . . . . . . . # . . . . . . . . . # . . . . . . # . . . . . . . . . . . . . . . . . . . . . . . . . . . . . . . . . . . . . . . . . . . . . . . . . . . . . . . . . . . . . # . . . . . . # . . . . . . . . . # . . . . . . . . . . . . . . . . . . . . . . . . .
. . . . . . . . . . . . . . . . . . . . . . . . # . . . . . . . . . # . . . . . . # . . . . . . . # # # # # # # # # # # # # # # # # # # # # # # # # # # # # # # # # # # # # # # # # # # # # # # # # . . . . . . . # . . . . . . # . . . . . . . . . # . . . . . . . . . . . . . . . . . . . . . . . .
. . . . . . . . . . . . . . . . . . . . . . . # . . . . . . . . . # . . . . . . # . . . . . . . # . . . . . . . . . . . . . . . . . . . . . . . . . . . . . . . . . . . . . . . . . . . . . . . . . # . . . . . . # . . . . . . # . . . . . . . . . # . . . . . . . . . . . . . . . . . . . . . . . .
. . . . . . . . . . . . . . . . . . . . . . . # . . . . . . . . . # . . . . . . # . . . . . . # . . . . . . . . . . . . . . . . . . . . . . . . . . . . . . . . . . . . . . . . . . . . . . . . . . . # . . . . . # . . . . . . # . . . . . . . . . # . . . . . . . . . . . . . . . . . . . . . . . .
. . . . . . . . . . . . . . . . . . . . . . . # . . . . . . . . . # . . . . . . # . . . . . # . . . . . . . . . . . . . . . . . . . . . . . . . . . . . . . . . . . . . . . . . . . . . . . . . . . . . # . . . . # . . . . . . # . . . . . . . . . # . . . . . . . . . . . . . . . . . . . . . . . .
. . . . . . . . . . . . . . . . . . . . . . . # . . . . . . . . . # . . . . . . # . . . . . . . . . . . . # # # # # # # # # # # # # # # . # # # # # # # # # # # # # # # # # # . # # # # # # . . . . . . . # . . . . . . . . . . # . . . . . . . . . # . . . . . . . . . . . . . . . . . . . . . . . .
. . . . . . . . . . . . . . . . . . . . . . . # . . . . . . . . . # . . . . . . # . . . . # . . . . . . # . . . . . . . . . . . . . . . . . . . . . . . . . . . . . . . . . . . . . . . . . # . . . . . . # . . . # . . . . . . # . . . . . . . . . # . . . . . . . . . . . . . . . . . . . . . . . .
. . . . . . . . . . . . . . . . . . . . . . . # . . . . . . . . . # . . . . . . # . . . . # . . . . . # . . . . . . . . . . . . . . . . . . . . . . . . . . . . . . . . . . . . . . . . . . . # . . . . . # . . . # . . . . . . # . . . . . . . . . # . . . . . . . . . . . . . . . . . . . . . . . .
. . . . . . . . . . . . . . . . . . . . . . . # . . . . . . . . . # . . . . . . # . . . . # . . . . # . . . . . . . . . . . . . . . . . . . . . . . . . . . . . . . . . . . . . . . . . . . . . # . . . . # . . . # . . . . . . # . . . . . . . . . # . . . . . . . . . . . . . . . . . . . . . . . .
. . . . . . . . . . . . . . . . . . . . . . . # . . . . . . . . . # . . . . . . # . . . . # . . . # . . . . . . . # # # # # # # # # # # # . # # # # # # # # # # # # # # # # # # # # . . . . . . . # . . . # . . . # . . . . . . # . . . . . . . . . # . . . . . . . . . . . . . . . . . . . . . . . .
. . . . . . . . . . . . . . . . . . . . . . . # . . . . . . . . . # . . . . . . # . . . . # . . . # . . . . . . # . . . . . . . . . . . . . . . . . . . . . . . . . . . . . . . . . # . . . . . . # . . . # . . . # . . . . . . # . . . . . . . . . # . . . . . . . . . . . . . . . . . . . . . . . .
. . . . . . . . . . . . . . . . . . . . . . . # . . . . . . . . . # . . . . . . # . . . . # . . . # . . . . . # . . . . . . . . . . . . . . . . . . . . . . . . . . . . . . . . . . . # . . . . . # . . . # . . . # . . . . . . # . . . . . . . . . # . . . . . . . . . . . . . . . . . . . . . . . .
. . . . . . . . . . . . . . . . . . . . . . . # . . . . . . . . . # . . . . . . # . . . . # . . . # . . . . # . . . . . . . . . . . . . . . . . . . . . . . . . . . . . . . . . . . . . # . . . . # . . . # . . . # . . . . . . # . . . . . . . . . # . . . . . . . . . . . . . . . . . . . . . . . .
. . . . . . . . . . . . . . . . . . . . . . . # . . . . . . . . . # . . . . . . # . . . . # . . . # . . . # . . . . . . . # # # # # # # # . # # # # # # # # # # # # # # . # # . . . . . . # . . . # . . . # . . . # . . . . . . # . . . . . . . . . # . . . . . . . . . . . . . . . . . . . . . . . .
. . . . . . . . . . . . . . . . . . . . . . . # . . . . . . . . . # . . . . . . # . . . . # . . . # . . . # . . . . . . # . . . . . . . . . . . . . . . . . . . . . . . . . . # . . . . . # . . . # . . . # . . . # . . . . . . # . . . . . . . . . # . . . . . . . . . . . . . . . . . . . . . . . .
. . . . . . . . . . . . . . . . . . . . . . . # . . . . . . . . . # . . . . . . # . . . . # . . . # . . . # . . . . . # . . . . . . . . . . . . . . . . . . . . . . . . . . . . # . . . . # . . . # . . . # . . . # . . . . . . # . . . . . . . . . # . . . . . . . . . . . . . . . . . . . . . . . .
. . . . . . . . . . . . . . . . . . . . . . . # . . . . . . . . . # . . . . . . # . . . . # . . . # . . . # . . . . # . . . . . # # # # # # # # # # # # # # # # # # # . . . . . . # . . . # . . . # . . . # . . . # . . . . . . # . . . . . . . . . # . . . . . . . . . . . . . . . . . . . . . . . .
. . . . . . . . . . . . . . . . . . . . . . . # . . . . . . . . . # . . . . . . # . . . . # . . . # . . . # . . . # . . . . . # . . . . . . . . . . . . . . . . . . . # . . . . . # . . . # . . . # . . . # . . . # . . . . . . # . . . . . . . . . # . . . . . . . . . . . . . . . . . . . . . . . .
. . . . . . . . . . . . . . . . . . . . . . . # . . . . . . . . . # . . . . . . # . . . . # . . . # . . . # . . . # . . . . # . . . . . . . . . . . . . . . . . . . . . l . . . . # . . . # . . . # . . . # . . . # . . . . . . # . . . . . . . . . # . . . . . . . . . . . . . . . . . . . . . . . .
. . . . . . . . . . . . . . . . . . . . . . . # . . . . . . . . . # . . . . . . # . . . . # . . . . . . . . . . . # . . . # . . . . . # . # # # # # # # # # # # . . . . . # . . . # . . . # . . . # . . . # . . . # . . . . . . # . . . . . . . . . # . . . . . . . . . . . . . . . . . . . . . . . .
. . . . . . . . . . . . . . . . . . . . . . . # . . . . . . . . . # . . . . . . # . . . . # . . . # . . . # . . . # . . . # . . . . # . . . . . . . . . . . . . # . . . . # . . . # . . . # . . . # . . . # . . . # . . . . . . # . . . . . . . . . # . . . . . . . . . . . . . . . . . . . . . . . .
. . . . . . . . . . . . . . . . . . . . . . . # . . . . . . . . . # . . . . . . # . . . . # . . . # . . . # . . . # . . . # . . . # . . . . . . . . . . . . . . . # . . . # . . . # . . . # . . . # . . . # . . . # . . . . . . # . . . . . . . . . # . . . . . . . . . . . . . . . . . . . . . . . .
. . . . . . . . . . . . . . . . . . . . . . . # . . . . . . . . . # . . . . . . # . . . . # . . . # . . . # . . . # . . . # . . # . . . . . # # # # # . # . . . . . # . . # . . . # . . . # . . . # . . . # . . . # . . . . . . # . . . . . . . . . # . . . . . . . . . . . . . . . . . . . . . . . .
. . . . . . . . . . . . . . . . . . . . . . . # . . . . . . . . . # . . . . . . # . . . . # . . . # . . . # . . . # . . . # . . # . . . . # . . . . . . . # . . . . # . . # . . . # . . . # . . . # . . . # . . . # . . . . . . # . . . . . . . . . # . . . . . . . . . . . . . . . . . . . . . . . .
. . . . . . . . . . . . . . . . . . . . . . . # . . . . . . . . . # . . . . . . # . . . . # . . . # . . . # . . . # . . . # . . # . . . # . . . . . . . . . # . . . # . . # . . . # . . . # . . . # . . . # . . . # . . . . . . # . . . . . . . . . # . . . . . . . . . . . . . . . . . . . . . . . .
. . . . . . . . . . . . . . . . . . . . . . . # . . . . . . . . . # . . . . . . # . . . . # . . . # . . . # . . . # . . . # . . # . . # . . . . # # # . . . . # . . # . . # . . . # . . . # . . . # . . . # . . . # . . . . . . # . . . . . . . . . # . . . . . . . . . . . . . . . . . . . . . . . .
. . . . . . . . . . . . . . . . . . . . . . . # . . . . . . . . . # . . . . . . # . . . . # . . . # . . . # . . . # . . . . . . # . . # . . . # . . . . . . . # . . # . . # . . . # . . . # . . . # . . . # . . . # . . . . . . # . . . . . . . . . # . . . . . . . . . . . . . . . . . . . . . . . .
. . . . . . . . . . . . . . . . . . . . . . . # . . . . . . . . . # . . . . . . # . . . . # . . . # . . . # . . . # . . . # . . # . . # . . # . . . . . # . . # . . # . . # . . . # . . . # . . . # . . . # . . . . . . . . . . # . . . . . . . . . # . . . . . . . . . . . . . . . . . . . . . . . .
. . . 1 . . . . . . . . . . . . . . . . . . . # . . . . . . . . . # . . . . . . # . . . . # . . . # . . . # . . . # . . . # . . # . . # . . # . . 0 . . # . . # . . # . . # . . . # . . . # . . . # . . . # . . . # . . . . . . # . . . . . . . . . # . . . . . . . . . . . . . . . . . . . . . . . .
. . . . . . . . . . . . . . . . . . . . . . . # . . . . . . . . . # . . . . . . # . . . . # . . . # . . . # . . . # . . . # . . # . . # . . # . . . . . # . . # . . # . . # . . . # . . . # . . . # . . . # . . . # . . . . . . # . . . . . . . . . # . . . . . . . . . . . . . . . . . . . . . . . .
. . . . . . . . . . . . . . . . . . . . . . . # . . . . . . . . . # . . . . . . # . . . . # . . . # . . . # . . . # . . . # . . # . . # . . . . . . . # . . . # . . # . . # . . . # . . . # . . . # . . . # . . . # . . . . . . # . . . . . . . . . # . . . . . . . . . . . . . . . . . . . . . . . .
. . . . . . . . . . . . . . . . . . . . . . . # . . . . . . . . . # . . . . . . # . . . . # . . . # . . . # . . . # . . . # . . # . . # . . . . # # # . . . . # . . # . . # . . . # . . . # . . . # . . . # . . . # . . . . . . # . . . . . . . . . # . . . . . . . . . . . . . . . . . . . . . . . .
. . . . . . . . . . . . . . . . . . . . . . . # . . . . . . . . . # . . . . . . # . . . . # . . . # . . . # . . . # . . . # . . # . . . # . . . . . . . . . # . . . # . . . . . . # . . . # . . . # . . . # . . . # . . . . . . # . . . . . . . . . # . . . . . . . . . . . . . . . . . . . . . . . .
. . . . . . . . . . . . . . . . . . . . . . . # . . . . . . . . . # . . . . . . # . . . . # . . . # . . . # . . . # . . . # . . # . . . . # . . . . . . . # . . . . # . . # . . . # . . . # . . . # . . . # . . . # . . . . . . # . . . . . . . . . # . . . . . . . . . . . . . . . . . . . . . . . .
. . . . . . . . . . . . . . . . . . . . . . . # . . . . . . . . . # . . . . . . # . . . . # . . . # . . . # . . . # . . . # . . # . . . . . # # # . # # # . . . . . # . . # . . . # . . . # . . . # . . . # . . . # . . . . . . # . . . . . . . . . # . . . . . . . . . . . . . . . . . . . . . . . .
. . . . . . . . . . . . . . . . . . . . . . . # . . . . . . . . . # . . . . . . # . . . . # . . . # . . . # . . . # . . . . . . . # . . . . . . . . . . . . . . . # . . . # . . . # . . . # . . . # . . . # . . . # . . . . . . # . . . . . . . . . # . . . . . . . . . . . . . . . . . . . . . . . .
. . . . . . . . . . . . . . . . . . . . . . . # . . . . . . . . . # . . . . . . # . . . . . . . . # . . . # . . . # . . . # . . . . # . . . . . . . . . . . . . # . . . . # . . . # . . . # . . . # . . . # . . . # . . . . . . # . . . . . . . . . # . . . . . . . . . . . . . . . . . . . . . . . .
. . . . . . . . . . . . . . . . . . . . . . . # . . . . . . . . . # . . . . . . # . . . . # . . . # . . . # . . . # . . . # . . . . . # # # # # # # # # # # # # . . . . . # . . . # . . . # . . . # . . . # . . . # . . . . . . # . . . . . . . . . # . . . . . . . . . . . . . . . . . . . . . . . .
. . . . . . . . . . . . . . . . . . . . . . . # . . . . . . . . . # . . . . . . # . . . . # . . . # . . . # . . . # . . . . # . . . . . . . . . . . . . . . . . . . . . # . . . . # . . . # . . . # . . . # . . . # . . . . . . # . . . . . . . . . # . . . . . . . . . . . . . . . . . . . . . . . .
. . . . . . . . . . . . . . . . . . . . . . . # . . . . . . . . . # . . . . . . # . . . . # . . . # . . . # . . . # . . . . . # . . . . . . . . . . . . . . . . . . . # . . . . . # . . . # . . . # . . . # . . . # . . . . . . # . . . . . . . . . # . . . . . . . . . . . . . . . . . . . . . . . .
. . . . . . . . . . . . . . . . . . . . . . . # . . . . . . . . . # . . . . . . # . . . . # . . . # . . . # . . . . . . . . . . # # # # # # # # # # # # # # # . # # # . . . . . # . . . . # . . . # . . . # . . . # . . . . . . # . . . . . . . . . # . . . . . . . . . . . . . . . . . . . . . . . .
. . . . . . . . . . . . . . . . . . . . . . . # . . . . . . . . . # . . . . . . # . . . . # . . . # . . . # . . . . . # . . . . . . . . . . . . . . . . . . . . . . . . . . . # . . . . . # . . . # . . . # . . . # . . . . . . # . . . . . . . . . # . . . . . . . . . . . . . . . . . . . . . . . .
. . . . . . . . . . . . . . . . . . . . . . . # . . . . . . . . . # . . . . . . # . . . . # . . . # . . . # . . . . . . # . . . . . . . . . . . . . . . . . . . . . . . . . . . . . . . . # . . . # . . . # . . . # . . . . . . # . . . . . . . . . # . . . . . . . . . . . . . . . . . . . . . . . .
. . . . . . . . . . . . . . . . . . . . . . . # . . . . . . . . . # . . . . . . # . . . . # . . . # . . . # . . . . . . . # # # # # # # . # # # # # # # # # # # # # # # # # . . . . . . . # . . . # . . . # . . . # . . . . . . # . . . . . . . . . # . . . . . . . . . . . . . . . . . . . . . . . .
. . . . . . . . . . . . . . . . . . . . . . . # . . . . . . . . . # . . . . . . # . . . . # . . . # . . . . # . . . . . . . . . . . . . . . . . . . . . . . . . . . . . . . . . . . . . # . . . . # . . . # . . . # . . . . . . # . . . . . . . . . # . . . . . . . . . . . . . . . . . . . . . . . .
. . . . . . . . . . . . . . . . . . . . . . . # . . . . . . . . . # . . . . . . # . . . . # . . . # . . . . . # . . . . . . . . . . . . . . . . . . . . . . . . . . . . . . . . . . . # . . . . . # . . . # . . . # . . . . . . # . . . . . . . . . # . . . . . . . . . . . . . . . . . . . . . . . .
. . . . . . . . . . . . . . . . . . . . . . . # . . . . . . . . . # . . . . . . # . . . . # . . . # . . . . . . # . . . . . . . . . . . . . . . . . . . . . . . . . . . . . . . . . # . . . . . . # . . . # . . . # . . . . . . # . . . . . . . . . # . . . . . . . . . . . . . . . . . . . . . . . .
. . . . . . . . . . . . . . . . . . . . . . . # . . . . . . . . . # . . . . . . # . . . . # . . . # . . . . . . . # # # # # # # # # # # # # # # # # # # # # # # # # # # # # # # # # . . . . . . . # . . . # . . . # . . . . . . # . . . . . . . . . # . . . . . . . . . . . . . . . . . . . . . . . .
. . . . . . . . . . . . . . . . . . . . . . . # . . . . . . . . . # . . . . . . # . . . . # . . . . # . . . . . . . . . . . . . . . . . . . . . . . . . . . . . . . . . . . . . . . . . . . . . # . . . . # . . . # . . . . . . # . . . . . . . . . # . . . . . . . . . . . . . . . . . . . . . . . .
. . . . . . . . . . . . . . . . . . . . . . . # . . . . . . . . . # . . . . . . # . . . . # . . . . . # . . . . . . . . . . . . . . . . . . . . . . . . . . . . . . . . . . . . . . . . . . . # . . . . . # . . . # . . . . . . # . . . . . . . . . # . . . . . . . . . . . . . . . . . . . . . . . .
. . . . . . . . . . . . . . . . . . . . . . . # . . . . . . . . . # . . . . . . # . . . . # . . . . . . # . . . . . . . . . . . . . . . . . . . . . . . . . . . . . . . . . . . . . . . . . # . . . . . . # . . . # . . . . . . # . . . . . . . . . # . . . . . . . . . . . . . . . . . . . . . . . .
. . . . . . . . . . . . . . . . . . . . . . . # . . . . . . . . . # . . . . . . # . . . . # . . . . . . . # # # # . # # # # # # # # # # # # # # # # # # # # # # # # # # # # # # # # # # # # . . . . . . . # . . . # . . . . . . # . . . . . . . . . # . . . . . . . . . . . . . . . . . . . . . . . .
. . . . . . . . . . . . . . . . . . . . . . . # . . . . . . . . . # . . . . . . # . . . . . # . . . . . . . . . . . . . . . . . . . . . . . . . . . . . . . . . . . . . . . . . . . . . . . . . . . . . # . . . . # . . . . . . # . . . . . . . . . # . . . . . . . . . . . . . . . . . . . . . . . .
. . . . . . . . . . . . . . . . . . . . . . . # . . . . . . . . . # . . . . . . # . . . . . . # . . . . . . . . . . . . . . . . . . . . . . . . . . . . . . . . . . . . . . . . . . . . . . . . . . . # . . . . . # . . . . . . # . . . . . . . . . # . . . . . . . . . . . . . . . . . . . . . . . .
. . . . . . . . . . . . . . . . . . . . . . . # . . . . . . . . . # . . . . . . # . . . . . . . # . . . . . . . . . . . . . . . . . . . . . . . . . . . . . . . . . . . . . . . . . . . . . . . . . # . . . . . . # . . . . . . # . . . . . . . . . # . . . . . . . . . . . . . . . . . . . . . . . .
. . . . . . . . . . . . . . . . . . . . . . . # . . . . . . . . . # . . . . . . # . . . . . . . . # # # # # # # # # # # # # # # # # . # # # # # # # # # # # # # # # # # # # # # # # # # # # # . # # . . . . . . . # . . . . . . # . . . . . . . . . # . . . . . . . . . . . . . . . . . . . . . . . .
. . . . . . . . . . . . . . . . . . . . . . . . # . . . . . . . . # . . . . . . . # . . . . . . . . . . . . . . . . . . . . . . . . . . . . . . . . . . . . . . . . . . . . . . . . . . . . . . . . . . . . . . # . . . . . . # . . . . . . . . . # . . . . . . . . . . . . . . . . . . . . . . . . .
. . . . . . . . . . . . . . . . . . . . . . . . . # . . . . . . . # . . . . . . . . # . . . . . . . . . . . . . . . . . . . . . . . . . . . . . . . . . . . . . . . . . . . . . . . . . . . . . . . . . . . . # . . . . . . # . . . . . . . . . # . . . . . . . . . . . . . . . . . . . . . . . . . .
. . . . . . . . . . . . . . . . . . . . . . . . . . # . . . . . . . # . . . . . . . . # . . . . . . . . . . . . . . . . . . . . . . . . . . . . . . . . . . . . . . . . . . . . . . . . . . . . . . . . . . # . . . . . . # . . . . . . . . . # . . . . . . . . . . . . . . . . . . . . . . . . . . .
. . . . . . . . . . . . . . . . . . . . . . . . . . . # . . . . . . . # . . . . . . . . # . # # # # # # # # # # # # # # # # # # # # # # # # # # # # # # # # # # # # # # # # # # # # # # # # # # # # # # # # . . . . . . # . . . . . . . . . # . . . . . . . . . . . . . . . . . . . . . . . . . . . .
. . . . . . . . . . . . . . . . . . . . . . . . . . . . # . . . . . . . # . . . . . . . . . . . . . . . . . . . . . . . . . . . . . . . . . . . . . . . . . . . . . . . . . . . . . . . . . . . . . . . . . . . . . . # . . . . . . . . . # . . . . . . . . . . . . . . . . . . . . . . . . . . . . .
. . . . . . . . . . . . . . . . . . . . . . . . . . . . . # . . . . . . . # . . . . . . . . . . . . . . . . . . . . . . . . . . . . . . . . . . . . . . . . . . . . . . . . . . . . . . . . . . . . . . . . . . . . # . . . . . . . . . # . . . . . . . . . . . . . . . . . . . . . . . . . . . . . .
. . . . . . . . . . . . . . . . . . . . . . . . . . . . . . # . . . . . . . # # # # # # # # # # # # # # # # # # # # # # # # # # # # # # # # # # # # # # # # # # # # # # # # # # # # # # # # # # # # # # # # # # # # . . . . . . . . . # . . . . . . . . . . . . . . . . . . . . . . . . . . . . . . .
. . . . . . . . . . . . . . . . . . . . . . . . . . . . . . . # . . . . . . . . . . . . . . . . . . . . . . . . . . . . . . . . . . . . . . . . . . . . . . . . . . . . . . . . . . . . . . . . . . . . . . . . . . . . . . . . . . # . . . . . . . . . . . . . . . . . . . . . . . . . . . . . . . .
. . . . . . . . . . . . . . . . . . . . . . . . . . . . . . . . # . . . . . . . . . . . . . . . . . . . . . . . . . . . . . . . . . . . . . . . . . . . . . . . . . . . . . . . . . . . . . . . . . . . . . . . . . . . . . . . . # . . . . . . . . . . . . . . . . . . . . . . . . . . . . . . . . .
. . . . . . . . . . . . . . . . . . . . . . . . . . . . . . . . . # # # # # # # # # # # # # # # # # # # # # # # # # # # # # # # # # # # # # # # # # # # # # # # # # # # # # # # # # # # # # # # # # # # # # # # # # # # # # # # # . . . . . . . . . . . . . . . . . . . . . . . . . . . . . . . . . .
# # # # # # # # # # # # # # # # # # # # # # # # # # # # # # # # # # # # # # # # # # # # # # # # # # # # # # # # # # # # # # # # # # # # # # # # # # # # # # # # # # # # # # # # # # # # # # # # # # # # # # # # # # # # # # # # # # # # # # # # # # # # # # # # # # # # # # # # # # # # # # # # # # #
# # # # # # # # # # # # # # # # # # # # # # # # # # # # # # # # # # # # # # # # # # # # # # # # # # # # # # # # # # # # # # # # # # # # # # # # # # # # # # # # # # # # # # # # # # # # # # # # # # # # # # # # # # # # # # # # # # # # # # # # # # # # # # # # # # # # # # # # # # # # # # # # # # #
