# # # # # # # # # # # # # # # # # # # # # # # # # # # # # # # # # # # # # # # # # # # # # # # # # # # # # # # # # # # # # # # # # # # # # # # # # # # # # # # # # # # # # # # # # # # # # # # # # # # # # # # # # # # # # # # # # # # # # # # # # # # # # # # # # # # # # # # # # # # # # # # # # # #
# # # # # # # # # # # # # # # # # # # # # # # # # # # # # # # # # # # # # # # # # # # # # # # # # # # # # # # # # # # # # # # # # # # # # # # # # # # # # # # # # # # # # # # # # # # # # # # # # # # # # # # # # # # # # # # # # # # # # # # # # # # # # # # # # # # # # # # # # # # # # # # # # # #
# . . . . . . . . . . . . . . . . . . . . . . . . . . . . . . . . . # # # # # # # # # # # # # # # # # # # # # # # # # # # # # # # # # # # # # # # # # # # # # # # # # # # # # # # # # # # # # # # # # # # # # # # # # # # # # # # . . . . . . . . . . . . . . . . . . . . . . . . . . . . . . . . . #
# . . . . . . . . . . . . . . . . . . . . . . . . . . . . . . . # . . . . . . . . . . . . . . . . . . . . . . . . . . . . . . . . . . . . . . . . . . . . . . . . . . . . . . . . . . . . . . . . . . . . . . . . . . . . . . . . . # . . . . . . . . . . . . . . . . . . . . . . . . . . . . . . . #
# . . . . . . . . . . . . . . . . . . . . . . . . . . . . . . # . . . . . . . . . # # # # # # # # # # # # # # # # # # # # # # # # # # # # # # # # # # # # # # # # # # # # # # # # # # # # # # # # # # # # # # # # # . . . . . . . . . # . . . . . . . . . . . . . . . . . . . . . . . . . . . . . . #
# . . . . . . . . . . . . . . . . . . . . . . . . . . . . . # . . . . . . . . . # . . . . . . . . . . . . . . . . . . . . . . . . . . . . . . . . . . . . . . . . . . . . . . . . . . . . . . . . . . . . . . . . . # . . . . . . . . . # . . . . . . . . . . . . . . . . . . . . . . . . . . . . . #
# . . . . . . . . . . . . . . . . . . . . . . . . . . . . # . . . . . . . . . # . . . . . . . . . . . . . . . . . . . . . . . . . . . . . . . . . . . . . . . . . . . . . . . . . . . . . . . . . . . . . . . . . . . # . . . . . . . . . # . . . . . . . . . . . . . . . . . . . . . . . . . . . . #
# . . . . . . . . . . . . . . . . . . . . . . . . . . . # . . . . . . . . . # . . . . . . # # # # # # # # . # # # # # # # # # # # # # # # # # # # # # # # # # # # # # # # # # # # # # # # # # # # # # # # # . . . . . . # . . . . . . . . . # . . . . . . . . . . . . . . . . . . . . . . . . . . . #
# . . . . . . . . . . . . . . . . . . . . . . . . . . # . . . . . . . . . . . . . . . . # . . . . . . . . . . . . . . . . . . . . . . . . . . . . . . . . . . . . . . . . . . . . . . . . . . . . . . . . . # . . . . . . # . . . . . . . . . # . . . . . . . . . . . . . . . . . . . . . . . . . . #
# . . . . . . . . . . . . . . . . . . . . . . . . . # . . . . . . . . . # . . . . . . # . . . . . . . . . . . . . . . . . . . . . . . . . . . . . . . . . . . . . . . . . . . . . . . . . . . . . . . . . . . # . . . . . . # . . . . . . . . . # . . . . . . . . . . . . . . . . . . . . . . . . . #
# . . . . . . . . . . . . . . . . . . . . . . . . # . . . . . . . . . # . . . . . . # . . . . . . . . . . . . . . . . . . . . . . . . . . . . . . . . . . . . . . . . . . . . . . . . . . . . . . . . . . . . . # . . . . . . # . . . . . . . . . # . . . . . . . . . . . . . . . . . . . . . . . . #
# . . . . . . . . . . . . . . . . . . . . . . . # . . . . . . . . . # . . . . . . # . . . . . . . # # # # # # # # # # # # # # # # # # # # # # # # # # # # # # # # # # # # # # # # # # # # # # # # # . . . . . . . # . . . . . . # . . . . . . . . . # . . . . . . . . . . . . . . . . . . . . . . . #
# . . . . . . . . . . . . . . . . . . . . . . # . . . . . . . . . # . . . . . . # . . . . . . . # . . . . . . . . . . . . . . . . . . . . . . . . . . . . . . . . . . . . . . . . . . . . . . . . . # . . . . . . # . . . . . . # . . . . . . . . . # . . . . . . . . . . . . . . . . . . . . . . . #
# . . . . . . . . . . . . . . . . . . . . . . # . . . . . . . . . # . . . . . . # . . . . . . # . . . . . . . . . . . . . . . . . . . . . . . . . . . . . . . . . . . . . . . . . . . . . . . . . . . # . . . . . # . . . . . . # . . . . . . . . . # . . . . . . . . . . . . . . . . . . . . . . . #
# . . . . . . . . . . . . . . . . . . . . . . # . . . . . . . . . # . . . . . . # . . . . . # . . . . . . . . . . . . . . . . . . . . . . . . . . . . . . . . . . . . . . . . . . . . . . . . . . . . . # . . . . # . . . . . . # . . . . . . . . . # . . . . . . . . . . . . . . . . . . . . . . . #
# . . . . . . . . . . . . . . . . . . . . . . # . . . . . . . . . # . . . . . . # . . . . . . . . . . . . # # # # # # # # # # # # # # # . # # # # # # # # # # # # # # # # # # . # # # # # # . . . . . . . # . . . . . . . . . . # . . . . . . . . . # . . . . . . . . . . . . . . . . . . . . . . . #
# . . . . . . . . . . . . . . . . . . . . . . # . . . . . . . . . # . . . . . . # . . . . # . . . . . . # . . . . . . . . . . . . . . . . . . . . . . . . . . . . . . . . . . . . . . . . . # . . . . . . # . . . # . . . . . . # . . . . . . . . . # . . . . . . . . . . . . . . . . . . . . . . . #
# . . . . . . . . . . . . . . . . . . . . . . # . . . . . . . . . # . . . . . . # . . . . # . . . . . # . . . . . . . . . . . . . . . . . . . . . . . . . . . . . . . . . . . . . . . . . . . # . . . . . # . . . # . . . . . . # . . . . . . . . . # . . . . . . . . . . . . . . . . . . . . . . . #
# . . . . . . . . . . . . . . . . . . . . . . # . . . . . . . . . # . . . . . . # . . . . # . . . . # . . . . . . . . . . . . . . . . . . . . . . . . . . . . . . . . . . . . . . . . . . . . . # . . . . # . . . # . . . . . . # . . . . . . . . . # . . . . . . . . . . . . . . . . . . . . . . . #
# . . . . . . . . . . . . . . . . . . . . . . # . . . . . . . . . # . . . . . . # . . . . # . . . # . . . . . . . # # # # # # # # # # # # . # # # # # # # # # # # # # # # # # # # # . . . . . . . # . . . # . . . # . . . . . . # . . . . . . . . . # . . . . . . . . . . . . . . . . . . . . . . . #
# . . . . . . . . . . . . . . . . . . . . . . # . . . . . . . . . # . . . . . . # . . . . # . . . # . . . . . . # . . . . . . . . . . . . . . . . . . . . . . . . . . . . . . . . . # . . . . . . # . . . # . . . # . . . . . . # . . . . . . . . . # . . . . . . . . . . . . . . . . . . . . . . . #
# . . . . . . . . . . . . . . . . . . . . . . # . . . . . . . . . # . . . . . . # . . . . # . . . # . . . . . # . . . . . . . . . . . . . . . . . . . . . . . . . . . . . . . . . . . # . . . . . # . . . # . . . # . . . . . . # . . . . . . . . . # . . . . . . . . . . . . . . . . . . . . . . . #
# . . . . . . . . . . . . . . . . . . . . . . # . . . . . . . . . # . . . . . . # . . . . # . . . # . . . . # . . . . . . . . . . . . . . . . . . . . . . . . . . . . . . . . . . . . . # . . . . # . . . # . . . # . . . . . . # . . . . . . . . . # . . . . . . . . . . . . . . . . . . . . . . . #
# . . . . . . . . . . . . . . . . . . . . . . # . . . . . . . . . # . . . . . . # . . . . # . . . # . . . # . . . . . . . # # # # # # # # . # # # # # # # # # # # # # # . # # . . . . . . # . . . # . . . # . . . # . . . . . . # . . . . . . . . . # . . . . . . . . . . . . . . . . . . . . . . . #
# . . . . . . . . . . . . . . . . . . . . . . # . . . . . . . . . # . . . . . . # . . . . # . . . # . . . # . . . . . . # . . . . . . . . . . . . . . . . . . . . . . . . . . # . . . . . # . . . # . . . # . . . # . . . . . . # . . . . . . . . . # . . . . . . . . . . . . . . . . . . . . . . . #
# . . . . . . . . . . . . . . . . . . . . . . # . . . . . . . . . # . . . . . . # . . . . # . . . # . . . # . . . . . # . . . . . . . . . . . . . . . . . . . . . . . . . . . . # . . . . # . . . # . . . # . . . # . . . . . . # . . . . . . . . . # . . . . . . . . . . . . . . . . . . . . . . . #
# . . . . . . . . . . . . . . . . . . . . . . # . . . . . . . . . # . . . . . . # . . . . # . . . # . . . # . . . . # . . . . . # # # # # # # # # # # # # # # # # # # . . . . . . # . . . # . . . # . . . # . . . # . . . . . . # . . . . . . . . . # . . . . . . . . . . . . . . . . . . . . . . . #
# . . . . . . . . . . . . . . . . . . . . . . # . . . . . . . . . # . . . . . . # . . . . # . . . # . . . # . . . # . . . . . # . . . . . . . . . . . . . . . . . . . # . . . . . # . . . # . . . # . . . # . . . # . . . . . . # . . . . . . . . . # . . . . . . . . . . . . . . . . . . . . . . . #
# . . . . . . . . . . . . . . . . . . . . . . # . . . . . . . . . # . . . . . . # . . . . # . . . # . . . # . . . # . . . . # . . . . . . . . . . . . . . . . . . . . . # . . . . # . . . # . . . # . . . # . . . # . . . . . . # . . . . . . . . . # . . . . . . . . . . . . . . . . . . . . . . . #
# . . . . . . . . . . . . . . . . . . . . . . # . . . . . . . . . # . . . . . . # . . . . # . . . . . . . . . . . # . . . # . . . . . # . # # # # # # # # # # # . . . . . # . . . # . . . # . . . # . . . # . . . # . . . . . . # . . . . . . . . . # . . . . . . . . . . . . . . . . . . . . . . . #
# . . . . . . . . . . . . . . . . . . . . . . # . . . . . . . . . # . . . . . . # . . . . # . . . # . . . # . . . # . . . # . . . . # . . . . . . . . . . . . . # . . . . # . . . # . . . # . . . # . . . # . . . # . . . . . . # . . . . . . . . . # . . . . . . . . . . . . . . . . . . . . . . . #
# . . . . . . . . . . . . . . . . . . . . . . # . . . . . . . . . # . . . . . . # . . . . # . . . # . . . # . . . # . . . # . . . # . . . . . . . . . . . . . . . # . . . # . . . # . . . # . . . # . . . # . . . # . . . . . . # . . . . . . . . . # . . . . . . . . . . . . . . . . . . . . . . . #
# . . . . . . . . . . . . . . . . . . . . . . # . . . . . . . . . # . . . . . . # . . . . # . . . # . . . # . . . # . . . # . . # . . . . . # # # # # . # . . . . . # . . # . . . # . . . # . . . # . . . # . . . # . . . . . . # . . . . . . . . . # . . . . . . . . . . . . . . . . . . . . . . . #
# . . . . . . . . . . . . . . . . . . . . . . # . . . . . . . . . # . . . . . . # . . . . # . . . # . . . # . . . # . . . # . . # . . . . # . . . . . . . # . . . . # . . # . . . # . . . # . . . # . . . # . . . # . . . . . . # . . . . . . . . . # . . . . . . . . . . . . . . . . . . . . . . . #
# . . . . . . . . . . . . . . . . . . . . . . # . . . . . . . . . # . . . . . . # . . . . # . . . # . . . # . . . # . . . # . . # . . . # . . . . . . . . . # . . . # . . # . . . # . . . # . . . # . . . # . . . # . . . . . . # . . . . . . . . . # . . . . . . . . . . . . . . . . . . . . . . . #
# . . . . . . . . . . . . . . . . . . . . . . # . . . . . . . . . # . . . . . . # . . . . # . . . # . . . # . . . # . . . # . . # . . # . . . . # # # . . . . # . . # . . # . . . # . . . # . . . # . . . # . . . # . . . . . . # . . . . . . . . . # . . . . . . . . . . . . . . . . . . . . . . . #
# . . . . . . . . . . . . . . . . . . . . . . # . . . . . . . . . # . . . . . . # . . . . # . . . # . . . # . . . # . . . . . . # . . # . . . # . . . . . . . # . . # . . # . . . # . . . # . . . # . . . # . . . # . . . . . . # . . . . . . . . . # . . . . . . . . . . . . . . . . . . . . . . . #
# . . . . . . . . . . . . . . . . . . . . . . # . . . . . . . . . # . . . . . . # . . . . # . . . # . . . # . . . # . . . # . . # . . # . . # . . . . . # . . # . . # . . # . . . # . . . # . . . # . . . # . . . . . . . . . . # . . . . . . . . . # . . . . . . . . . . . . . . . . . . . . . . . #
# . . 1 . . . . . . . . . . . . . . . . . . . # . . . . . . . . . # . . . . . . # . . . . # . . . # . . . # . . . # . . . # . . # . . # . . # . . 0 . . # . . # . . # . . # . . . # . . . # . . . # . . . # . . . # . . . . . . # . . . . . . . . . # . . . . . . . . . . . . . . . . . . . . . . . #
# . . . . . . . . . . . . . . . . . . . . . . # . . . . . . . . . # . . . . . . # . . . . # . . . # . . . # . . . # . . . # . . # . . # . . # . . . . . # . . # . . # . . # . . . # . . . # . . . # . . . # . . . # . . . . . . # . . . . . . . . . # . . . . . . . . . . . . . . . . . . . . . . . #
# . . . . . . . . . . . . . . . . . . . . . . # . . . . . . . . . # . . . . . . # . . . . # . . . # . . . # . . . # . . . # . . # . . # . . . . . . . # . . . # . . # . . # . . . # . . . # . . . # . . . # . . . # . . . . . . # . . . . . . . . . # . . . . . . . . . . . . . . . . . . . . . . . #
# . . . . . . . . . . . . . . . . . . . . . . # . . . . . . . . . # . . . . . . # . . . . # . . . # . . . # . . . # . . . # . . # . . # . . . . # # # . . . . # . . # . . # . . . # . . . # . . . # . . . # . . . # . . . . . . # . . . . . . . . . # . . . . . . . . . . . . . . . . . . . . . . . #
# . . . . . . . . . . . . . . . . . . . . . . # . . . . . . . . . # . . . . . . # . . . . # . . . # . . . # . . . # . . . # . . # . . . # . . . . . . . . . # . . . # . . . . . . # . . . # . . . # . . . # . . . # . . . . . . # . . . . . . . . . # . . . . . . . . . . . . . . . . . . . . . . . #
# . . . . . . . . . . . . . . . . . . . . . . # . . . . . . . . . # . . . . . . # . . . . # . . . # . . . # . . . # . . . # . . # . . . . # . . . . . . . # . . . . # . . # . . . # . . . # . . . # . . . # . . . # . . . . . . # . . . . . . . . . # . . . . . . . . . . . . . . . . . . . . . . . #
# . . . . . . . . . . . . . . . . . . . . . . # . . . . . . . . . # . . . . . . # . . . . # . . . # . . . # . . . # . . . # . . # . . . . . # # # . # # # . . . . . # . . # . . . # . . . # . . . # . . . # . . . # . . . . . . # . . . . . . . . . # . . . . . . . . . . . . . . . . . . . . . . . #
# . . . . . . . . . . . . . . . . . . . . . . # . . . . . . . . . # . . . . . . # . . . . # . . . # . . . # . . . # . . . . . . . # . . . . . . . . . . . . . . . # . . . # . . . # . . . # . . . # . . . # . . . # . . . . . . # . . . . . . . . . # . . . . . . . . . . . . . . . . . . . . . . . #
# . . . . . . . . . . . . . . . . . . . . . . # . . . . . . . . . # . . . . . . # . . . . . . . . # . . . # . . . # . . . # . . . . # . . . . . . . . . . . . . # . . . . # . . . # . . . # . . . # . . . # . . . # . . . . . . # . . . . . . . . . # . . . . . . . . . . . . . . . . . . . . . . . #
# . . . . . . . . . . . . . . . . . . . . . . # . . . . . . . . . # . . . . . . # . . . . # . . . # . . . # . . . # . . . # . . . . . # # # # # # # # # # # # # . . . . . # . . . # . . . # . . . # . . . # . . . # . . . . . . # . . . . . . . . . # . . . . . . . . . . . . . . . . . . . . . . . #
# . . . . . . . . . . . . . . . . . . . . . . # . . . . . . . . . # . . . . . . # . . . . # . . . # . . . # . . . # . . . . # . . . . . . . . . . . . . . . . . . . . . # . . . . # . . . # . . . # . . . # . . . # . . . . . . # . . . . . . . . . # . . . . . . . . . . . . . . . . . . . . . . . #
# . . . . . . . . . . . . . . . . . . . . . . # . . . . . . . . . # . . . . . . # . . . . # . . . # . . . # . . . # . . . . . # . . . . . . . . . . . . . . . . . . . # . . . . . # . . . # . . . # . . . # . . . # . . . . . . # . . . . . . . . . # . . . . . . . . . . . . . . . . . . . . . . . #
# . . . . . . . . . . . . . . . . . . . . . . # . . . . . . . . . # . . . . . . # . . . . # . . . # . . . # . . . . . . . . . . # # # # # # # # # # # # # # # . # # # . . . . . # . . . . # . . . # . . . # . . . # . . . . . . # . . . . . . . . . # . . . . . . . . . . . . . . . . . . . . . . . #
# . . . . . . . . . . . . . . . . . . . . . . # . . . . . . . . . # . . . . . . # . . . . # . . . # . . . # . . . . . # . . . . . . . . . . . . . . . . . . . . . . . . . . . # . . . . . # . . . # . . . # . . . # . . . . . . # . . . . . . . . . # . . . . . . . . . . . . . . . . . . . . . . . #
# . . . . . . . . . . . . . . . . . . . . . . # . . . . . . . . . # . . . . . . # . . . . # . . . # . . . # . . . . . . # . . . . . . . . . . . . . . . . . . . . . . . . . . . . . . . . # . . . # . . . # . . . # . . . . . . # . . . . . . . . . # . . . . . . . . . . . . . . . . . . . . . . . #
# . . . . . . . . . . . . . . . . . . . . . . # . . . . . . . . . # . . . . . . # . . . . # . . . # . . . # . . . . . . . # # # # # # # . # # # # # # # # # # # # # # # # # . . . . . . . # . . . # . . . # . . . # . . . . . . # . . . . . . . . . # . . . . . . . . . . . . . . . . . . . . . . . #
# . . . . . . . . . . . . . . . . . . . . . . # . . . . . . . . . # . . . . . . # . . . . # . . . # . . . . # . . . . . . . . . . . . . . . . . . . . . . . . . . . . . . . . . . . . . # . . . . # . . . # . . . # . . . . . . # . . . . . . . . . # . . . . . . . . . . . . . . . . . . . . . . . #
# . . . . . . . . . . . . . . . . . . . . . . # . . . . . . . . . # . . . . . . # . . . . # . . . # . . . . . # . . . . . . . . . . . . . . . . . . . . . . . . . . . . . . . . . . . # . . . . . # . . . # . . . # . . . . . . # . . . . . . . . . # . . . . . . . . . . . . . . . . . . . . . . . #
# . . . . . . . . . . . . . . . . . . . . . . # . . . . . . . . . # . . . . . . # . . . . # . . . # . . . . . . # . . . . . . . . . . . . . . . . . . . . . . . . . . . . . . . . . # . . . . . . # . . . # . . . # . . . . . . # . . . . . . . . . # . . . . . . . . . . . . . . . . . . . . . . . #
# . . . . . . . . . . . . . . . . . . . . . . # . . . . . . . . . # . . . . . . # . . . . # . . . # . . . . . . . # # # # # # # # # # # # # # # # # # # # # # # # # # # # # # # # # . . . . . . . # . . . # . . . # . . . . . . # . . . . . . . . . # . . . . . . . . . . . . . . . . . . . . . . . #
# . . . . . . . . . . . . . . . . . . . . . . # . . . . . . . . . # . . . . . . # . . . . # . . . . # . . . . . . . . . . . . . . . . . . . . . . . . . . . . . . . . . . . . . . . . . . . . . # . . . . # . . . # . . . . . . # . . . . . . . . . # . . . . . . . . . . . . . . . . . . . . . . . #
# . . . . . . . . . . . . . . . . . . . . . . # . . . . . . . . . # . . . . . . # . . . . # . . . . . # . . . . . . . . . . . . . . . . . . . . . . . . . . . . . . . . . . . . . . . . . . . # . . . . . # . . . # . . . . . . # . . . . . . . . . # . . . . . . . . . . . . . . . . . . . . . . . #
# . . . . . . . . . . . . . . . . . . . . . . # . . . . . . . . . # . . . . . . # . . . . # . . . . . . # . . . . . . . . . . . . . . . . . . . . . . . . . . . . . . . . . . . . . . . . . # . . . . . . # . . . # . . . . . . # . . . . . . . . . # . . . . . . . . . . . . . . . . . . . . . . . #
# . . . . . . . . . . . . . . . . . . . . . . # . . . . . . . . . # . . . . . . # . . . . # . . . . . . . # # # # . # # # # # # # # # # # # # # # # # # # # # # # # # # # # # # # # # # # # . . . . . . . # . . . # . . . . . . # . . . . . . . . . # . . . . . . . . . . . . . . . . . . . . . . . #
# . . . . . . . . . . . . . . . . . . . . . . # . . . . . . . . . # . . . . . . # . . . . . # . . . . . . . . . . . . . . . . . . . . . . . . . . . . . . . . . . . . . . . . . . . . . . . . . . . . . # . . . . # . . . . . . # . . . . . . . . . # . . . . . . . . . . . . . . . . . . . . . . . #
# . . . . . . . . . . . . . . . . . . . . . . # . . . . . . . . . # . . . . . . # . . . . . . # . . . . . . . . . . . . . . . . . . . . . . . . . . . . . . . . . . . . . . . . . . . . . . . . . . . # . . . . . # . . . . . . # . . . . . . . . . # . . . . . . . . . . . . . . . . . . . . . . . #
# . . . . . . . . . . . . . . . . . . . . . . # . . . . . . . . . # . . . . . . # . . . . . . . # . . . . . . . . . . . . . . . . . . . . . . . . . . . . . . . . . . . . . . . . . . . . . . . . . # . . . . . . # . . . . . . # . . . . . . . . . # . . . . . . . . . . . . . . . . . . . . . . . #
# . . . . . . . . . . . . . . . . . . . . . . # . . . . . . . . . # . . . . . . # . . . . . . . . # # # # # # # # # # # # # # # # # . # # # # # # # # # # # # # # # # # # # # # # # # # # # # . # # . . . . . . . # . . . . . . # . . . . . . . . . # . . . . . . . . . . . . . . . . . . . . . . . #
# . . . . . . . . . . . . . . . . . . . . . . . # . . . . . . . . # . . . . . . . # . . . . . . . . . . . . . . . . . . . . . . . . . . . . . . . . . . . . . . . . . . . . . . . . . . . . . . . . . . . . . . # . . . . . . # . . . . . . . . . # . . . . . . . . . . . . . . . . . . . . . . . . #
# . . . . . . . . . . . . . . . . . . . . . . . . # . . . . . . . # . . . . . . . . # . . . . . . . . . . . . . . . . . . . . . . . . . . . . . . . . . . . . . . . . . . . . . . . . . . . . . . . . . . . . # . . . . . . # . . . . . . . . . # . . . . . . . . . . . . . . . . . . . . . . . . . #
# . . . . . . . . . . . . . . . . . . . . . . . . . # . . . . . . . # . . . . . . . . # . . . . . . . . . . . . . . . . . . . . . . . . . . . . . . . . . . . . . . . . . . . . . . . . . . . . . . . . . . # . . . . . . # . . . . . . . . . # . . . . . . . . . . . . . . . . . . . . . . . . . . #
# . . . . . . . . . . . . . . . . . . . . . . . . . . # . . . . . . . # . . . . . . . . # . # # # # # # # # # # # # # # # # # # # # # # # # # # # # # # # # # # # # # # # # # # # # # # # # # # # # # # # # . . . . . . # . . . . . . . . . # . . . . . . . . . . . . . . . . . . . . . . . . . . . #
# . . . . . . . . . . . . . . . . . . . . . . . . . . . # . . . . . . . # . . . . . . . . . . . . . . . . . . . . . . . . . . . . . . . . . . . . . . . . . . . . . . . . . . . . . . . . . . . . . . . . . . . . . . # . . . . . . . . . # . . . . . . . . . . . . . . . . . . . . . . . . . . . . #
# . . . . . . . . . . . . . . . . . . . . . . . . . . . . # . . . . . . . # . . . . . . . . . . . . . . . . . . . . . . . . . . . . . . . . . . . . . . . . . . . . . . . . . . . . . . . . . . . . . . . . . . . . # . . . . . . . . . # . . . . . . . . . . . . . . . . . . . . . . . . . . . . . #
# . . . . . . . . . . . . . . . . . . . . . . . . . . . . . # . . . . . . . # # # # # # # # # # # # # # # # # # # # # # # # # # # # # # # # # # # # # # # # # # # # # # # # # # # # # # # # # # # # # # # # # # # # . . . . . . . . . # . . . . . . . . . . . . . . . . . . . . . . . . . . . . . . #
# . . . . . . . . . . . . . . . . . . . . . . . . . . . . . . # . . . . . . . . . . . . . . . . . . . . . . . . . . . . . . . . . . . . . . . . . . . . . . . . . . . . . . . . . . . . . . . . . . . . . . . . . . . . . . . . . . # . . . . . . . . . . . . . . . . . . . . . . . . . . . . . . . #
# . . . . . . . . . . . . . . . . . . . . . . . . . . . . . . . # . . . . . . . . . . . . . . . . . . . . . . . . . . . . . . . . . . . . . . . . . . . . . . . . . . . . . . . . . . . . . . . . . . . . . . . . . . . . . . . . # . . . . . . . . . . . . . . . . . . . . . . . . . . . . . . . . #
# . . . . . . . . . . . . . . . . . . . . . . . . . . . . . . . . # # # # # # # # # # # # # # # # # # # # # # # # # # # # # # # # # # # # # # # # # # # # # # # # # # # # # # # # # # # # # # # # # # # # # # # # # # # # # # # # . . . . . . . . . . . . . . . . . . . . . . . . . . . . . . . . . #
# # # # # # # # # # # # # # # # # # # # # # # # # # # # # # # # # # # # # # # # # # # # # # # # # # # # # # # # # # # # # # # # # # # # # # # # # # # # # # # # # # # # # # # # # # # # # # # # # # # # # # # # # # # # # # # # # # # # # # # # # # # # # # # # # # # # # # # # # # # # # # # # # # #
# # # # # # # # # # # # # # # # # # # # # # # # # # # # # # # # # # # # # # # # # # # # # # # # # # # # # # # # # # # # # # # # # # # # # # # # # # # # # # # # # # # # # # # # # # # # # # # # # # # # # # # # # # # # # # # # # # # # # # # # # # # # # # # # # # # # # # # # # # # # # # # # # # #
