# # # # # # # # # # # # # # # # # # # # # # # # # # # # # # # # # # # # # # # # # # # # # # # # # # # # # # # # # # # # # # # # # # # # # # # # # # # # # # # # # # # # # # # # # # # # # # # # # # # # # # # # # # # # # # # # # # # # # # # # # # # # # # # # # # # # # # # # # # # # # # # # # # #
# # # # # # # # # # # # # # # # # # # # # # # # # # # # # # # # # # # # # # # # # # # # # # # # # # # # # # # # # # # # # # # # # # # # # # # # # # # # # # # # # # # # # # # # # # # # # # # # # # # # # # # # # # # # # # # # # # # # # # # # # # # # # # # # # # # # # # # # # # # # # # # # # # #
# . # . . . # . . . # . . . . . . . . . # . # . . . . . . . . . . . . . . . # . # . # . . . . . # . # . # . # . # . . . # . . . # . # . . . # . . . . . # . # . . . # . . . # . . . # . . . . . . . . . # . # . # . # . # . # . # . # . . . . . # . . . # . # . . . . . # . # . . . # . # . . . # . #
# . # . # # # . # # # . # # # . # # # # # . # . # # # . # # # . . . . . . . # # # . # . # # # # # . # . # # # . # . # # # . # . # # # . . . # # # . . . # . # # # . # # # . # # # . # # # # # . # # # # # . # . # # # . # . # . # . # . # # # . # # # . # . # # # . # # # . # # # . # # # . . . # # #
# . . . # . # . # . . . # . # . # . . . . . # . # . # . # . # . . . . . . . . . . . # . . . # . . . # . . . . . # . # . . . # . . . . . . . . . # . . . # . . . # . . . # . . . # . . . . . # . # . . . . . # . . . . . # . # . # . # . . . # . . . # . # . . . . . # . . . . . . . . . . . . . . . #
# # # . # . # . # # # . # . # # # . # # # . # # # . # # # . # . . . . . # # # # # . # # # . # # # . # # # # # . # . # # # # # . . . # # # . . . # . . . # # # . # # # . # # # . # # # # # . # # # . . . . . # . # . # # # . # . # . # # # . # . # . # # # . # # # . # # # # # # # . # # # . # # # # #
# . # . # . # . . . # . . . . . . . # . # . . . . . . . . . # . . . . . # . . . # . . . # . . . # . . . . . # . . . . . . . . . . . # . # . . . . . . . . . . . . . # . . . # . # . . . # . . . . . . . . . # . # . # . # . # . # . . . # . # . # . . . . . # . # . . . . . . . # . # . . . # . . . #
# . # . # . # . # # # . # # # # # . # . # # # # # . # # # # # . # # # # # # # . # # # # # . # # # . # # # . # . # # # . # # # # # # # . # . . . # # # . # # # # # . # . # # # . # # # . # . # . # # # # # . # # # . # . # # # . # . # . # # # . # # # # # # # . # # # # # # # # # . # # # . # # # . #
# . # . . . # . # . . . . . # . # . # . . . . . # . . . # . # . # . . . . . # . . . . . . . # . . . # . # . # . # . # . # . . . . . . . # . . . # . . . # . . . # . # . # . . . . . . . # . # . . . . . # . . . . . # . . . . . . . # . . . . . . . . . . . . . # . . . . . . . . . . . # . . . # . #
# . # # # # # . # . # # # # # . # . # # # . # # # . # # # . # # # . # # # . # . # # # . # # # . . . # . # . # # # . # . # . # . # . # . # . # # # . # # # . # . # . # . # # # # # . # # # . # # # . # . # . . . . . # # # . # . # # # . # # # # # # # # # # # . # . # # # # # . # . # # # . # # # . #
# . . . . . . . # . # . . . . . # . . . . . . . . . # . . . . . . . # . # . # . . . . . # . . . . . # . # . . . . . # . # . # . # . # . # . # . . . # . . . # . # . # . . . # . # . # . . . . . # . # . # . . . . . . . # . # . # . . . # . # . . . . . . . # . # . # . . . . . # . # . # . # . . . #
# . # # # . # # # . # . # # # . # . # # # . # # # . # # # . # . # # # . # # # . # # # . # . # # # . # . # . # # # # # . # # # . # # # . # # # . # # # . # . # . # . # . # # # . # . # # # # # . # # # . # # # # # # # . # # # . # # # # # . # # # . # # # # # . # . # . # # # # # . # . # # # # # # #
# . # . # . # . . . # . # . # . # . . . # . # . # . . . # . # . # . . . . . . . # . # . # . # . # . # . . . . . . . . . . . # . . . . . . . . . # . # . . . # . # . # . # . . . # . . . . . # . . . . . . . . . . . # . . . . . . . . . # . . . # . . . . . . . # . # . # . . . . . . . . . . . . . #
# . # . # . # . # # # . # . # . # # # . # # # . # . # . # # # . # . # # # . # # # . # # # . # . # . # # # . # # # # # # # . # . # # # # # # # # # . # # # # # . # # # . # # # . # # # # # . # . # # # # # . # # # # # # # # # . # # # . # . # # # . # # # . # . # # # . # # # . # . # # # # # . # # #
# . # . # . # . # . . . . . # . . . # . . . . . # . # . . . . . # . # . # . # . # . . . . . . . # . . . # . # . . . . . # . # . # . # . . . . . . . . . . . . . . . . . . . # . . . . . # . # . # . # . . . # . . . . . . . # . # . # . # . . . . . # . # . # . . . . . . . # . # . # . . . # . # . #
# . # . # . # . # # # # # . # # # . # # # . # . # # # . # # # # # . # . # . # . # . # # # # # . # # # # # . # # # . # . # # # . # . # # # # # # # # # # # . # # # # # # # . # # # . # # # . # . # . # . # # # . # . # # # . # . # . # . # # # . # # # . # # # # # # # . # . # # # . # # # . # . # # #
# . # . # . # . # . # . # . # . # . # . . . # . . . . . . . . . # . . . # . # . . . # . . . # . . . . . . . # . # . # . # . # . . . # . # . # . # . . . . . . . # . . . # . # . # . # . # . . . . . . . # . # . . . # . # . . . . . . . # . . . . . . . # . # . . . . . # . # . . . . . . . # . . . #
# . # . # . # # # . # # # . # . # . # # # # # # # # # # # # # . # # # # # . # . # # # . # # # . # . # # # . # # # . # . # . # # # . # . # . # . # # # . # # # . # . . . # . # # # . # . # # # . # # # . # # # . . . # . # # # # # # # . # # # . . . # # # . # # # # # # # . # # # # # . . . # . # # #
# . # . . . # . . . . . . . . . # . # . . . . . . . . . . . # . # . # . # . . . . . . . # . # . # . # . . . . . . . # . . . # . . . . . # . . . # . . . . . # . . . # . # . # . . . . . # . . . # . # . # . # . # . . . # . # . # . . . # . . . # . # . # . # . . . # . # . # . # . . . # . # . . . #
# . # . # # # . # # # # # # # # # . # # # # # # # # # . # # # . # # # . # . # # # . # # # . # # # . # # # # # . # . # . . . # # # . # # # . # # # . # # # . # # # . # # # . # # # # # . # # # # # . # . # # # . # . # . # . # . # # # # # . # # # . # . # . # # # . # . # # # . # # # . # . # . # # #
# . # . # . . . # . . . . . # . . . . . . . . . . . # . . . . . . . # . # . # . # . # . . . . . . . . . . . . . # . # . . . . . # . # . . . . . . . # . # . . . # . . . . . . . . . # . . . . . . . # . . . . . # . # . # . # . . . . . . . # . # . # . # . . . # . . . . . . . . . # . # . # . . . #
# . # . # . # . # . . . . . # . # # # . # # # # # # # . # # # # # . # . # . # . # . # # # . # # # . # # # . # # # # # . # # # # # . # # # . # # # # # . # . # . # . # # # . # # # # # . # # # # # . # . # # # . # . # . # # # . . . . . # # # . # # # . # # # . # . # # # . . . # # # . # . # # # # #
# . # . # . # . # . . . . . # . # . # . . . . . . . . . # . . . # . . . # . # . # . . . . . # . # . # . # . # . . . . . # . . . # . . . # . # . . . . . # . # . # . # . # . # . . . . . . . . . # . . . # . # . # . # . . . . . . . . . # . . . . . . . . . # . # . # . # . . . # . . . # . . . . . #
# . # . # . # . # . # # # # # . # . # # # # # . # # # . # . # . # # # . # # # . # # # # # # # . # # # . # . # # # . # # # . # # # . # # # . # . . . . . # . # . # # # . # . # . # # # # # # # # # . # # # . # # # . # # # . # # # # # . # . # # # . # # # . # . # # # . # . . . # # # # # . # . # # #
# . # . # . # . # . # . . . # . # . . . . . # . # . # . # . # . . . # . . . . . . . . . . . . . . . . . # . . . # . . . . . # . . . # . . . . . . . . . # . . . . . . . # . # . . . . . . . # . . . # . . . . . . . . . # . # . . . # . # . # . # . # . # . # . # . . . # . . . . . . . . . # . # . #
# . # . # . # # # . # # # . # . # # # . # . # . # . # . # . # # # . # . # # # # # . # # # . # # # . # # # . . . # . # # # # # . # # # . # # # . . . # # # . # # # . # # # . # # # # # . # # # . . . # # # # # # # # # # # . # . # # # . # . # . # . # . # # # . # # # . # . # # # . # # # . # # # . #
# . # . # . . . . . . . . . # . . . # . # . # . # . # . # . . . . . # . # . . . # . . . # . # . . . # . . . . . # . # . . . . . # . . . # . # . . . # . . . # . # . # . . . . . . . . . . . . . . . . . . . . . . . . . . . # . . . . . # . # . # . # . . . . . . . . . # . . . . . # . # . # . . . #
# . # # # . # # # . # # # . # . # # # . # . # # # . # # # . # # # . # # # . . . # # # # # . # # # # # . . . . . # # # . . . . . # # # # # . # # # # # . # # # . # # # . # # # . # # # # # # # . . . . . # # # . # # # # # . # # # # # . # # # . # # # . # # # . # # # . # # # # # . # . # # # . # # #
# . . . . . # . # . # . # . # . # . . . # . # . . . . . . . # . # . . . . . . . . . . . . . . . . . . . . . . . . . . . . . . . . . . . . . . . . . . . # . . . . . . . # . . . # . # . . . # . . . . . # . # . . . # . # . # . . . # . . . . . . . # . . . # . # . # . . . . . # . . . . . . . # . #
# . # # # # # . # . # . # . # . # . # . # . # . # # # . # # # . # . # # # . # # # . . . # # # # # # # # # . # # # # # . # # # # # # # . # # # . . . . . # . . . . . # # # . # # # . # # # . # # # # # # # . # # # . # . # . # # # . # # # . # # # . # # # # # . # . # # # . # . # # # . # # # # # # #
# . # . . . . . # . # . # . # . # . # . # . . . # . # . # . . . . . # . # . # . # . . . # . . . . . . . # . # . . . # . # . . . . . . . # . # . . . . . # . . . . . # . . . # . . . . . . . . . . . . . . . . . # . # . # . . . . . # . . . # . # . . . . . . . # . . . # . # . . . # . # . . . . . #
# . # # # # # . # . # . # # # . # . # . # . # # # . # # # . # # # . # . # . # . # # # # # # # . # # # . # # # . # # # . # # # . # # # . # . # . # # # # # . # # # # # # # . # . # # # # # . # # # . # # # . # # # . # . # # # # # . # # # . # . # # # # # # # # # . # # # . # # # # # . # # # . # # #
# . . . # . . . # . # . . . . . # . # . # . # . . . . . . . # . # . . . # . . . . . . . . . . . # . # . . . . . # . . . # . . . # . # . # . # . # . . . . . # . . . . . . . # . . . . . # . # . # . # . # . # . . . # . . . . . . . . . # . # . . . . . . . . . . . # . # . . . . . # . . . # . . . #
# # # # # # # # # . # # . # . # # # # # # . # # # . # # # # # . # . # . # # . # . # # # # # . # # # # # . # # # # # . # # # # # # # # # # # # # # # # # # # # # # # # # # # # # # # # # # # # # # # # # # # # # # # # # # # # # # # # # # # # # # # # # # # # # # # # # # # # # # # # # # # # # # # #
# # # # # # # # # . . . . # . # # # # . . . # # . . . . # # # . # . # . # # . # . # # # # # . . . # # # . # . . . . . # # # # # # # # # # # # # # # # # # # # # # # # # # # # # # # # # # # # # # # # # # # # # # # # # # # # # # # # # # # # # # # # # # # # # # # # # # # # # # # # # # # # # # # #
# # . . . . # # # . # # # # . . # # # . # # # # . # # . # # # . # . # . # . . # . . . . . # # # . . # # . # . . # # . # # # # # # # # # # # # # # # # # # # # # # # # # # # # # # # # # # # # # # # # # # # # # # # # # # # # # # # # # # # # # # # # # # # # # # # # # # # # # # # # # # . . . # # #
# # . # # . # # # . # # # # # . # # # . # # # # . # # . # # # . # . # # # . # # # # # # . # # # # . # # . # # # # # . # # # # # # # # # # # # # # # # # # # # # # # # # # # # # # # # # # # # # # # # # # # # # # # # # # # # # # # # # # # # # # # # # # # # # # # # # # # # # # # # # # . # . # # #
# # . # # . # # . . . . . . . . . . . . . . . . . . . . . . . . . . . . . . . . . . . . . . . . . . . . . . . . . . . . . . . . . . . . . . . . . . . . . . . . . . . . . . . . . . . . . . . . . . . . . . . . . . . . . . . . . . . . . . . . . . . . . . . . . . . . . . . . . . . # # . # . # # #
# # . # # . # . . . . . . . . . . . . . . . . . . . . . . . . . . . . . . . . . . . . . . . . . . . . . . . . . . . . . . . . . . . . . . . . . . . . . . . . . . . . . . . . . . . . . . . . . . . . . . . . . . . . . . . . . . . . . . . . . . . . . . . . . . . . . . . . . . . . . # . # . # # #
# # . # # . . . . . . . . . . . . . . . . . . . . . . . . . . . . . . . . . . . . . . . . . . . . . . . . . . . . . . . . . . . . . . . . . . . . . . . . . . . . . . . . . . . . . . . . . . . . . . . . . . . . . . . . . . . . . . . . . . . . . . . . . . . . . . . . . . . . . . . . . # . # # #
# # . # # . . . . . . . . . . . . . . . . . . . . . . . . . . . . . . . . . . . . . . . . . . . . . . . . . . . . . . . . . . . . . . . . . . . . . . . . . . . . . . . . . . . . . . . . . . . . . . . . . . . . . . . . . . . . . . . . . . . . . . . . . . . . . . . . . . . . . . . . . # . # # #
# # # # . . . . . . . . . . . . . . . . . . . . . . . . . . . . . . . . . . . . . . . . . . . . . . . . . . . . . . . . . . . . . . . . . . . . . . . . . . . . . . . . . . . . . . . . . . . . . . . . . . . . . . . . . . . . . . . . . . . . . . . . . . . . . . . . . . . . . . . . . . . # # # #
# # # . . . . . . . . . . . . . . . . . . . . . . . . . . . . . . . . . . . . . . . . . . . . . . . . . . . . . . . . . . . . . . . . . . . . . . . . . . . . . . . . . . . . . . . . . . . . . . . . . . . . . . . . . . . . . . . . . . . . . . . . . . . . . . . . . . . . . . . . . . . . . # # #
# 0 . . . . . . . . . . . . . . . . . . . . . . . . . . . . . . . . . . . . . . . . . . . . . . . . . . . . . . . . . . . . . . . . . . . . . . . . . . . . . . . . . . . . . . . . . . . . . . . . . . . . . . . . . . . . . . . . . . . . . . . . . . . . . . . . . . . . . . . . . . . . . . . 1 #
# # # . . . . . . . . . . . . . . . . . . . . . . . . . . . . . . . . . . . . . . . . . . . . . . . . . . . . . . . . . . . . . . . . . . . . . . . . . . . . . . . . . . . . . . . . . . . . . . . . . . . . . . . . . . . . . . . . . . . . . . . . . . . . . . . . . . . . . . . . . . . . . # # #
# # # # . . . . . . . . . . . . . . . . . . . . . . . . . . . . . . . . . . . . . . . . . . . . . . . . . . . . . . . . . . . . . . . . . . . . . . . . . . . . . . . . . . . . . . . . . . . . . . . . . . . . . . . . . . . . . . . . . . . . . . . . . . . . . . . . . . . . . . . . . . . # # # #
# # # # # . . . . . . . . . . . . . . . . . . . . . . . . . . . . . . . . . . . . . . . . . . . . . . . . . . . . . . . . . . . . . . . . . . . . . . . . . . . . . . . . . . . . . . . . . . . . . . . . . . . . . . . . . . . . . . . . . . . . . . . . . . . . . . . . . . . . . . . . . # # # # #
# # . # # . # . . . . . . . . . . . . . . . . . . . . . . . . . . . . . . . . . . . . . . . . . . . . . . . . . . . . . . . . . . . . . . . . . . . . . . . . . . . . . . . . . . . . . . . . . . . . . . . . . . . . . . . . . . . . . . . . . . . . . . . . . . . . . . . . . . . . . . . # # # # #
# # . # # . # # . . . . . . . . . . . . . . . . . . . . . . . . . . . . . . . . . . . . . . . . . . . . . . . . . . . . . . . . . . . . . . . . . . . . . . . . . . . . . . . . . . . . . . . . . . . . . . . . . . . . . . . . . . . . . . . . . . . . . . . . . . . . . . . . . . . . # . # . # ##.
# # . # # . # # # # # # # # # # # # # # # # # # # # # # # # # # # # # # # # # # # # # # # # # # # # # # # # # # # # # # # # # # # # # # # # # # # # # # # # # # # # # # # # # # # # # # # # # # # # # # # # # # # # # # # # # # # # # # # # # # # # # # # # # # # # # # # # # # # # # # # . # . # # #
# # . # # . # # # # # # # # # # # # # # # # # # # # # # # # # # # # # # # # # # # # # # # # # # # # # # # # # # # # # # # # # # # # # # # # # # # # # # # # # # # # # # # # # # # # # # # # # # # # # # # # # # # # # # # # # # # # # # # # # # # # # # # # # # # # # # # # # # # # # # # . # . # # #
# # . . . . # # # # # # # # # # # # # # # # # # # # # # # # # # # # # # # # # # # # # # # # # # # # # # # # # # # # # # # # # # # # # # # # # # # # # # # # # # # # # # # # # # # # # # # # # # # # # # # # # # # # # # # # # # # # # # # # # # # # # # # # # # # # # # # # # # # # # # # . . . # # #
# # # # # # # # # # # # # # # # # # # # # # # # # # # # # # # # # # # # # # # # # # # # # # # # # # # # # # # # # # # # # # # # # # # # # # # # # # # # # # # # # # # # # # # # # # # # # # # # # # # # # # # # # # # # # # # # # # # # # # # # # # # # # # # # # # # # # # # # # # # # # # # # # # #
# . # . # . # . . . . . . . # . # . # . # . # . # . . . # . # . # . # . . . # . # . . . . . # . . . . . . . # . # . # . . . . . . . . . . . . . . . . . # . . . . . . . # . . . . . # . . . . . . . . . # . # . # . . . # . . . . . # . # . # . # . . . # . . . # . . . # . . . # . . . # . . . # . #
# . # # # . # . . . # # # . # # # . # . # . # . # # # . # # # . # . # . # # # . # # # # # # # . . . . . . . # # # . # . # # # # # . # # # # # . # # # # # # # . # # # . # . # # # . # # # # # # # . # # # . # . # . # # # . # # # # # . # . # . # . # . # # # . # . # # # . # # # . . . # . # # # . #
# . . . . . # . . . # . . . . . . . . . . . # . . . # . . . . . # . # . # . . . . . . . # . . . . . . . . . . . . . . . # . . . # . # . # . . . # . . . . . # . # . . . # . # . # . # . . . . . . . # . . . # . . . # . . . # . . . . . # . # . # . # . # . # . # . # . . . . . . . . . # . # . . . #
# . # # # . # # # . # # # . . . # # # # # . # . # . # . # # # # # # # . # . # # # # # . # . . . . . # # # # # . # # # # # . . . # # # . # # # # # . # # # # # . # # # . # # # . # # # . . . . . # # # . # . # # # # # . # . # # # # # . # # # . # # # . # . # # # . # . # # # # # # # . # . # # # . #
# . # . . . . . # . . . . . . . # . . . # . # . # . # . . . . . . . . . # . # . . . # . # . . . . . . . . . . . # . . . . . . . . . # . . . . . . . # . # . . . . . # . . . . . . . . . . . . . # . . . # . . . . . . . # . . . . . # . . . . . . . . . # . . . . . . . # . # . . . # . # . . . # . #
# . # # # . # # # . # # # . . . # # # . # . # . # . # # # . # # # . # # # . # . # # # . # # # . # # # # # . # # # . # # # # # . . . # . # . # # # . # . # # # . # # # . # # # . # # # . . . . . # # # . # # # # # . . . # # # # # . # # # . # # # # # . # . # # # . # # # . # . # # # . # # # . # # #
# . . . # . # . . . # . # . . . . . # . # . # . # . . . # . # . # . # . . . . . # . . . . . # . # . . . . . # . . . # . . . # . . . # . # . . . # . . . . . # . # . . . # . # . # . # . . . . . . . # . . . . . . . . . . . # . # . . . # . # . . . # . # . # . # . . . . . # . # . . . . . # . . . #
# . # # # . # # # . # . # # # # # # # . # . # . # # # # # . # . # . # # # # # . # . # # # # # . # . # # # . # . # # # . # # # # # . # . # # # . # # # # # . # . # # # . # . # . # . # . . . . . . . # # # . # # # . # # # . # . # . # # # . # # # . # . # . # . # # # # # . # . # # # . # # # . # # #
# . # . . . # . . . # . . . . . . . . . # . # . . . . . . . . . . . . . . . # . # . # . . . . . # . # . # . # . # . . . # . . . # . # . . . # . . . . . # . # . . . # . . . # . . . # . . . . . . . . . # . # . # . # . # . # . # . # . . . . . # . . . # . # . . . . . # . # . . . # . # . . . # . #
# . # . # # # . # # # . # # # . # # # # # . # . # # # . # # # . . . . . . . # # # . # . # # # # # . # . # # # . # . # # # . # . # # # . . . # # # . . . # . # # # . # # # . # # # . # # # # # . # # # # # . # . # # # . # . # . # . # . # # # . # # # . # . # # # . # # # . # # # . # # # . . . # # #
# . . . # . # . # . . . # . # . # . . . . . # . # . # . # . # . . . . . . . . . . . # . . . # . . . # . . . . . # . # . . . # . . . . . . . . . # . . . # . . . # . . . # . . . # . . . . . # . # . . . . . # . . . . . # . # . # . # . . . # . . . # . # . . . . . # . . . . . . . . . . . . . . . #
# # # . # . # . # # # . # . # # # . # # # . # # # . # # # . # . . . . . # # # # # . # # # . # # # . # # # # # . # . # # # # # . . . # # # . . . # . . . # # # . # # # . # # # . # # # # # . # # # . . . . . # . # . # # # . # . # . # # # . # . # . # # # . # # # . # # # # # # # . # # # . # # # # #
# . # . # . # . . . # . . . . . . . # . # . . . . . . . . . # . . . . . # . . . # . . . # . . . # . . . . . # . . . . . . . . . . . # . # . . . . . . . . . . . . . # . . . # . # . . . # . . . . . . . . . # . # . # . # . # . # . . . # . # . # . . . . . # . # . . . . . . . # . # . . . # . . . #
# . # . # . # . # # # . # # # # # . # . # # # # # . # # # # # . # # # # # # # . # # # # # . # # # . # # # . # . # # # . # # # # # # # . # . . . # # # . # # # # # . # . # # # . # # # . # . # . # # # # # . # # # . # . # # # . # . # . # # # . # # # # # # # . # # # # # # # # # . # # # . # # # . #
# . # . . . # . # . . . . . # . # . # . . . . . # . . . # . # . # . . . . . # . . . . . . . # . . . # . # . # . # . # . # . . . . . . . # . . . # . . . # . . . # . # . # . . . . . . . # . # . . . . . # . . . . . # . . . . . . . # . . . . . . . . . . . . . # . . . . . . . . . . . # . . . # . #
# . # # # # # . # . # # # # # . # . # # # . # # # . # # # . # # # . # # # . # . # # # . # # # . . . # . # . # # # . # . # . # . # . # . # . # # # . # # # . # . # . # . # # # # # . # # # . # # # . # . # . . . . . # # # . # . # # # . # # # # # # # # # # # . # . # # # # # . # . # # # . # # # . #
# . . . . . . . # . # . . . . . # . . . . . . . . . # . . . . . . . # . # . # . . . . . # . . . . . # . # . . . . . # . # . # . # . # . # . # . . . # . . . # . # . # . . . # . # . # . . . . . # . # . # . . . . . . . # . # . # . . . # . # . . . . . . . # . # . # . . . . . # . # . # . # . . . #
# . # # # . # # # . # . # # # . # . # # # . # # # . # # # . # . # # # . # # # . # # # . # . # # # . # . # . # # # # # . # # # . # # # . # # # . # # # . # . # . # . # . # # # . # . # # # # # . # # # . # # # # # # # . # # # . # # # # # . # # # . # # # # # . # . # . # # # # # . # . # # # # # # #
# . # . # . # . . . # . # . # . # . . . # . # . # . . . # . # . # . . . . . . . # . # . # . # . # . # . . . . . . . . . . . # . . . . . . . . . # . # . . . # . # . # . # . . . # . . . . . # . . . . . . . . . . . # . . . . . . . . . # . . . # . . . . . . . # . # . # . . . . . . . . . . . . . #
# . # . # . # . # # # . # . # . # # # . # # # . # . # . # # # . # . # # # . # # # . # # # . # . # . # # # . # # # # # # # . # . # # # # # # # # # . # # # # # . # # # . # # # . # # # # # . # . # # # # # . # # # # # # # # # . # # # . # . # # # . # # # . # . # # # . # # # . # . # # # # # . # # #
# . # . # . # . # . . . . . # . . . # . . . . . # . # . . . . . # . # . # . # . # . . . . . . . # . . . # . # . . . . . # . # . # . # . . . . . . . . . . . . . . . . . . . # . . . . . # . # . # . # . . . # . . . . . . . # . # . # . # . . . . . # . # . # . . . . . . . # . # . # . . . # . # . #
# # # # # # # # # # # # # # # # # # # # # # # # # # # # # # # # # # # # # # # # # # # # # # # # # # # # # # # # # # # # # # # # # # # # # # # # # # # # # # # # # # # # # # # # # # # # # # # # # # # # # # # # # # # # # # # # # # # # # # # # # # # # # # # # # # # # # # # # # # # # # # # # # # #
# # # # # # # # # # # # # # # # # # # # # # # # # # # # # # # # # # # # # # # # # # # # # # # # # # # # # # # # # # # # # # # # # # # # # # # # # # # # # # # # # # # # # # # # # # # # # # # # # # # # # # # # # # # # # # # # # # # # # # # # # # # # # # # # # # # # # # # # # # # # # # # # # # #
# # # # # # # # # # # # # # # # # # # # # # # # # # # # # # # # # # # # # # # # # # # # # # # # # # # # # # # # # # # # # # # # # # # # # # # # # # # # # # # # # # # # # # # # # # # # # # # # # # # # # # # # # # # # # # # # # # # # # # # # # # # # # # # # # # # # # # # # # # # # # # # # # # #
# # # # # # # # # # # # # # # # # # # # # # # # # # # # # # # # # # # # # # # # # # # # # # # # # # # # # # # # # # # # # # # # # # # # # # # # # # # # # # # # # # # # # # # # # # # # # # # # # # # # # # # # # # # # # # # # # # # # # # # # # # # # # # # # # # # # # # # # # # # # # # # # # # #
