# # # # # # # # # # # # # # # # # # # # # # # # # # # # # # # # # # # # # # # # # # # # # # # # # # # # # # # # # # # # # # # # # # # # # # # # # # # # # # # # # # # # # # # # # # # # # # # # # # # # # # # # # # # # # # # # # # # # # # # # # # # # # # # # # # # # # # # # # # # # # # # # # # #
# # # # # # # # # # # # # # # # # # # # # # # # # # # # # # # # # # # # # # # # # # # # # # # # # # # # # # # # # # # # # # # # # # # # # # # # # # # # # # # # # # # # # # # # # # # # # # # # # # # # # # # # # # # # # # # # # # # # # # # # # # # # # # # # # # # # # # # # # # # # # # # # # # #
# . . . # . # . # . . . # . # . # . . . . . # . # . # . # . # . . . . . . . . . . . # . . . # . . . # . . . . . # . # . . . # . . . . . . . . . # . . . # . . . # . . . # . . . # . . . . . # . # . . . . . # . . . . . # . # . # . # . . . # . . . # . # . . . . . # . . . . . . . . . . . . . . . #
# # # . # . # . # # # . # . # # # . # # # . # # # . # # # . # . . . . . # # # # # . # # # . # # # . # # # # # . # . # # # # # . . . # # # . . . # . . . # # # . # # # . # # # . # # # # # . # # # . . . . . # . # . # # # . # . # . # # # . # . # . # # # . # # # . # # # # # # # . # # # . # # # # #
# . # . # . # . . . # . . . . . . . # . # . . . . . . . . . # . . . . . # . . . # . . . # . . . # . . . . . # . . . . . . . . . . . # . # . . . . . . . . . . . . . # . . . # . # . . . # . . . . . . . . . # . # . # . # . # . # . . . # . # . # . . . . . # . # . . . . . . . # . # . . . # . . . #
# . # . # . # . # # # . # # # # # . # . # # # # # . # # # # # . # # # # # # # . # # # # # . # # # . # # # . # . # # # . # # # # # # # . # . . . # # # . # # # # # . # . # # # . # # # . # . # . # # # # # . # # # . # . # # # . # . # . # # # . # # # # # # # . # # # # # # # # # . # # # . # # # . #
# . # . . . # . # . . . . . # . # . # . . . . . # . . . # . # . # . . . . . # . . . . . . . # . . . # . # . # . # . # . # . . . . . . . # . . . # . . . # . . . # . # . # . . . . . . . # . # . . . . . # . . . . . # . . . . . . . # . . . . . . . . . . . . . # . . . . . . . . . . . # . . . # . #
# . # # # # # . # . # # # # # . # . # # # . # # # . # # # . # # # . # # # . # . # # # . # # # . . . # . # . # # # . # . # . # . # . # . # . # # # . # # # . # . # . # . # # # # # . # # # . # # # . # . # . . . . . # # # . # . # # # . # # # # # # # # # # # . # . # # # # # . # . # # # . # # # . #
# . . . . . . . # . # . . . . . # . . . . . . . . . # . . . . . . . # . # . # . . . . . # . . . . . # . # . . . . . # . # . # . # . # . # . # . . . # . . . # . # . # . . . # . # . # . . . . . # . # . # . . . . . . . # . # . # . . . # . # . . . . . . . # . # . # . . . . . # . # . # . # . . . #
# . # # # . # # # . # . # # # . # . # # # . # # # . # # # . # . # # # . # # # . # # # . # . # # # . # . # . # # # # # . # # # . # # # . # # # . # # # . # . # . # . # . # # # . # . # # # # # . # # # . # # # # # # # . # # # . # # # # # . # # # . # # # # # . # . # . # # # # # . # . # # # # # # #
# . # . # . # . . . # . # . # . # . . . # . # . # . . . # . # . # . . . . . . . # . # . # . # . # . # . . . . . . . . . . . # . . . . . . . . . # . # . . . # . # . # . # . . . # . . . . . # . . . . . . . . . . . # . . . . . . . . . # . . . # . . . . . . . # . # . # . . . . . . . . . . . . . #
# . # . # . # . # # # . # . # . # # # . # # # . # . # . # # # . # . # # # . # # # . # # # . # . # . # # # . # # # # # # # . # . # # # # # # # # # . # # # # # . # # # . # # # . # # # # # . # . # # # # # . # # # # # # # # # . # # # . # . # # # . # # # . # . # # # . # # # . # . # # # # # . # # #
# . # . # . # . # . . . . . # . . . # . . . . . # . # . . . . . # . # . # . # . # . . . . . . . # . . . # . # . . . . . # . # . # . # . . . . . . . . . . . . . . . . . . . # . . . . . # . # . # . # . . . # . . . . . . . # . # . # . # . . . . . # . # . # . . . . . . . # . # . # . . . # . # . #
# . # . # . # . # # # # # . # # # . # # # . # . # # # . # # # # # . # . # . # . # . # # # # # . # # # # # . # # # . # . # # # . # . # # # # # # # # # # # . # # # # # # # . # # # . # # # . # . # . # . # # # . # . # # # . # . # . # . # # # . # # # . # # # # # # # . # . # # # . # # # . # . # # #
# . # . # . # . # . # . # . # . # . # . . . # . . . . . . . . . # . . . # . # . . . # . . . # . . . . . . . # . # . # . # . # . . . # . # . # . # . . . . . . . # . . . # . # . # . # . # . . . . . . . # . # . . . # . # . . . . . . . # . . . . . . . # . # . . . . . # . # . . . . . . . # . . . #
# . # . # . # # # . # # # . # . # . # # # # # # # # # # # # # . # # # # # . # . # # # . # # # . # . # # # . # # # . # . # . # # # . # . # . # . # # # . # # # . # . . . # . # # # . # . # # # . # # # . # # # . . . # . # # # # # # # . # # # . . . # # # . # # # # # # # . # # # # # . . . # . # # #
# . # . . . # . . . . . . . . . # . # . . . . . . . . . . . # . # . # . # . . . . . . . # . # . # . # . . . . . . . # . . . # . . . . . # . . . # . . . . . # . . . # . # . # . . . . . # . . . # . # . # . # . # . . . # . # . # . . . # . . . # . # . # . # . . . # . # . # . # . . . # . # . . . #
# . # . # # # . # # # # # # # # # . # # # # # # # # # . # # # . # # # . # . # # # . # # # . # # # . # # # # # . # . # . . . # # # . # # # . # # # . # # # . # # # . # # # . # # # # # . # # # # # . # . # # # . # . # . # . # . # # # # # . # # # . # . # . # # # . # . # # # . # # # . # . # . # # #
# . # . # . . . # . . . . . # . . . . . . . . . . . # . . . . . . . # . # . # . # . # . . . . . . . . . . . . . # . # . . . . . # . # . . . . . . . # . # . . . # . . . . . . . . . # . . . . . . . # . . . . . # . # . # . # . . . . . . . # . # . # . # . . . # . . . . . . . . . # . # . # . . . #
# . # . # . # . # . . . . . # . # # # . # # # # # # # . # # # # # . # . # . # . # . # # # . # # # . # # # . # # # # # . # # # # # . # # # . # # # # # . # . # . # . # # # . # # # # # . # # # # # . # . # # # . # . # . # # # . . . . . # # # . # # # . # # # . # . # # # . . . # # # . # . # # # # #
# . # . # . # . # . . . . . # . # . # . . . . . . . . . # . . . # . . . # . # . # . . . . . # . # . # . # . # . . . . . # . . . # . . . # . # . . . . . # . # . # . # . # . # . . . . . . . . . # . . . # . # . # . # . . . . . . . . . # . . . . . . . . . # . # . # . # . . . # . . . # . . . . . #
# . # . # . # . # . # # # # # . # . # # # # # . # # # . # . # . # # # . # # # . # # # # # # # . # # # . # . # # # . # # # . # # # . # # # . # . . . . . # . # . # # # . # . # . # # # # # # # # # . # # # . # # # . # # # . # # # # # . # . # # # . # # # . # . # # # . # . . . # # # # # . # . # # #
# . # . # . # . # . # . . . # . # . . . . . # . # . # . # . # . . . # . . . . . . . . . . . . . . . . . # . . . # . . . . . # . . . # . . . . . . . . . # . . . . . . . # . # . . . . . . . # . . . # . . . . . . . . . # . # . . . # . # . # . # . # . # . # . # . . . # . . . . . . . . . # . # . #
# . # . # . # # # . # # # . # . # # # . # . # . # . # . # . # # # . # . # # # # # . # # # . # # # . # # # . . . # . # # # # # . # # # . # # # . . . # # # . # # # . # # # . # # # # # . # # # . . . # # # # # # # # # # # . # . # # # . # . # . # . # . # # # . # # # . # . # # # . # # # . # # # . #
# . # . # . . . . . . . . . # . . . # . # . # . # . # . # . . . . . # . # . . . # . . . # . # . . . # . . . . . # . # . . . . . # . . . # . # . . . # . . . # . # . # . . . . . . . . . . . . . . . . . . . . . . . . . . . # . . . . . # . # . # . # . . . . . . . . . # . . . . . # . # . # . . . #
# . # # # . # # # . # # # . # . # # # . # . # # # . # # # . # # # . # # # . . . # # # # # . # # # # # . . . . . # # # . . . . . # # # # # . # # # # # . # # # . # # # . # # # . # # # # # # # . . . . . # # # . # # # # # . # # # # # . # # # . # # # . # # # . # # # . # # # # # . # . # # # . # # #
# . . . . . # . # . # . # . # . # . . . # . # . . . . . . . # . # . . . . . . . . . . . . . . . . . . . . . . . . . . . . . . . . . . . . . . . . . . . # . . . . . . . # . . . # . # . . . # . . . . . # . # . . . # . # . # . . . # . . . . . . . # . . . # . # . # . . . . . # . . . . . . . # . #
# . # # # # # . # . # . # . # . # . # . # . # . # # # . # # # . # . # # # . # # # . . . # # # # # # # # # . # # # # # . # # # # # # # . # # # . . . . . # . . . . . # # # . # # # . # # # . # # # # # # # . # # # . # . # . # # # . # # # . # # # . # # # # # . # . # # # . # . # # # . # # # # # # #
# . # . . . . . # . # . # . # . # . # . # . . . # . # . # . . . . . # . # . # . # . . . # . . . . . . . # . # . . . # . # . . . . . . . # . # . . . . . # . . . . . # . . . # . . . . . . . . . . . . . . . . . # . # . # . . . . . # . . . # . # . . . . . . . # . . . # . # . . . # . # . . . . . #
# . # # # # # . # . # . # # # . # . # . # . # # # . # # # . # # # . # . # . # . # # # # # # # . # . # . # # # . # # # . # # # . # # # . # . # . # # # # # . # # # # # # # . # . # # # # # . # # # . # # # . # # # . # . # # # # # . # # # . # . # # # # # # # # # . # # # . # # # # # . # # # . # # #
# . . . . . # . # . # . # . # . # . # . # . # . . . . . # . # . # . . . # . # . . . . . . # . . # . # . # . . . # . . . . . # . # . # . # . # . # . . . . . # . . . . # . . # . . . . . # . # . # . # . # . # . . . # . . . . . . . . . # . # . . . . . . # . . . . # . # . . . . . # . . . # . . . # 
# . . . . . # . # . # . # . # . # . # . # . # . . # . . # . # . # . # . # . # . . . . # . # . . # . # . # . . . # # # # . . # . # . # . # . # . # . # # # . # . # # # # # # # . . # . . # . # . # . # . # . # . # . . . . . # . # . . . # . # # . # . # # # # # # . # . # . . # . # # # # . . . # . #
# . # # # # # . # . # . # . # . # . # . # . # . . # . . # . # . # . # # # . # # # # # # . # # . # . # . # # # . . . . # . . # . # . # . # . # . # . . . . . # . # . . . . . # # . # # # # . # . # . # . # . # . # # # # # # # . # # # # # . . # . # # # . . . . # . # . # . # # . # # . . . # . # . #
# . # . # . # # # . # # # . # . # . # # # # # # # # # # # # # . # # # # # . # . # # # . # # # . # . # # # . # # # . # . # . # # # . # . # . # . # # # . # # # . # . . . # . # # # . # . # # # . # # # . # # # . . . # . # # # # # # # . # # # . . . # # # . # # # # # # # . # # # # # . . . # . # # #
# . # . . . # . . . . . . . . . # . # . . . . . . . . . . . # . # . # . # . . . . . . . # . # . # . # . . . . . . . # . . . # . . . . . # . . . # . . . . . # . . . # . # . # . . . . . # . . . # . # . # . # . # . . . # . # . # . . . # . . . # . # . # . # . . . # . # . # . # . . . # . # . . . #
# . # . # # # . # # # # # # # # # . # # # # # # # # # . # # # . # # # . # . # # # . # # # . # # # . # # # # # . # . # . . . # # # . # # # . # # # . # # # . # # # . # # # . # # # # # . # # # # # . # . # # # . # . # . # . # . # # # # # . # # # . # . # . # # # . # . # # # . # # # . # . # . # # #
# . # . # . . . # . . . . . # . . . . . . . . . . . # . . . . . . . # . # . # . # . # . . . . . . . . . . . . . # . # . . . . . # . # . . . . . . . # . # . . . # . . . . . . . . . # . . . . . . . # . . . . . # . # . # . # . . . . . . . # . # . # . # . . . # . . . . . . . . . # . # . # . . . #
# . # . # . # . # . . . . . # # # # # . # # # # # # # . # # # # # . # . # . # . # . # # # . # # # . # # # . # # # # # . # # # # # . # # # . # # # # # . # . # . # . # # # . # # # # # . # # # # # . # . # # # . # . # . # # # . . . . . # # # . # # # . # # # . # . # # # . . . # # # . # . # # # # #
# . . . . . . . . . . . . . . . . . . . . . . . . . . . . . . . . . . . . . . . . . . . . . . . . . . . . . . . . . . . . . . . . . . . . . . . . . . . . . . . . . . . . . . . . . . . . . . . . . . . . . . . . . . . . . . . . . . . . . . . . . . . . . . . . . . . . . . . . . . . . . . . . . #
# 0 . . . . . . . . . . . . . . . . . . . . . . . . . . . . . . . . . . . . . . . . . . . . . . . . . . . . . . . . . . . . . . . . . . . . . . . . . . . . . . . . . . . . . . . . . . . . . . . . . . . . . . . . . . . . . . . . . . . . . . . . . . . . . . . . . . . . . . . . . . . . . . . 1 #
# . . . . . . . . . . . . . . . . . . . . . . . . . . . . . . . . . . . . . . . . . . . . . . . . . . . . . . . . . . . . . . . . . . . . . . . . . . . . . . . . . . . . . . . . . . . . . . . . . . . . . . . . . . . . . . . . . . . . . . . . . . . . . . . . . . . . . . . . . . . . . . . . . #
# . # . # . # . # # # . # . # . # # # # # # # . # . # . # # # . # . # # # . # # # . # # # . # . # . # # # . # # # # # # # . # . # # # # # # # # # . # # # # # . # # # . # # # . # # # # # . # . # # # # # . # # # # # # # # # . # # # . # . # # # . # # # . # . # # # . # # # . # . # # # # # . # # #
# . # . # . # . # . . . # . # . . . # . . . . . # . # . . . . . # . # . # . # . # . . . . . . . # . . . # . # . . . . . # . # . # . # . . . . . . . . . . . . . . . . . . . # . . . . . # . # . # . # . . . # . . . . . . . # . # . # . # . . . . . # . # . # . . . . . . . # . # . # . . . # . # . #
# . # . # . # . # . # # # . # . # . # # # # # . # . # . # . # . # # # . # # # . # # # # # # # . # # # . # . # # # . # # # . # # # . # # # . # . . . . . # . # . # # # . # . # . # # # # # # # # # . # # # . # # # . # # # . # # # # # . # . # # # . # # # . # . # # # . # . . . # # # # # . # . # # #
# . # . # . # . # . # . . . # . # . . . . . # . # # # . # . # . . . # . . . . . . . . . . . . . . . . . # . . . # . . . . . # . . . # . . . . . . . . . # . . . . . . . # . # . . . . . . . # . . . # . . . . . . . . . # . # . . . # . # . # . # . # . # . # . # . . . # . . . . . . . . . # . # . #
# . # # # . # # # # # # # . # # # . # . # . # . . # . . # # # # # # # . # . # . # . # . # . # # # # # . # . # . # . # . . . # . # . # # # # # # # . # . # . # # # # . # . . # . . . # . # # # # # . . # . # # # # # # # # . # # # # # . # . # . # . # # # # # . # # # # # . # # # . # . # . # . # . #
# . . . # . # . # . . . . . # . . . # . # . # . # # . . . . . . . . # . # . # . # . # . # # # . . . . . # . # . # . # # # . # . # . . . . . . . # . # . # . # . . # . # # . # # # . # . . . . # . . # # . . . . # . # . . . # . . . # . # . # . # . . . # . # . . . . . . . # . . . # . # . # . # . #
# . . . # . # . # . . . . . # . . . # . # . # . # . . . # . # # # . # . # . # . # . # . . . # . . # . . . . # . # . # . # . # . # . . . . . . . # . . . # . . . . # . . # . . . # . # . . . . # . . # . # . # . # . . . # . . . . . # . # . # . # . . . # . . . # . . . . . # . # . # . # . . . # . #
# . # . # . # . # # # # # . # # # . # # # . # . # # # . # # # . # . # . # # # . # # # . # # # # # # # # # . # . # . # . # # # . # . # # # # # . # # # # # # # . # # # . # . # # # . # # # # # # # . # # # . # . # . # # # . # # # # # . # . # . # . # . # # # . # . # # # . # # # # # . # . # # # . #
# . # . # . # . . . # . . . . . # . . . # . # . . . # . . . . . # . # . # . . . . . . . # . . . . . . . . . . . # . . . # . . . # . # . # . . . # . . . . . # . # . . . # . # . # . # . . . . . . . # . . . # . . . # . . . # . . . . . # . # . # # # . # . # . # . # . . . . . . . . . # . # . . . #
# . # . # . . . # # # . . . . . # . . . # . # . # . # . . . . . . . # . # # # # # . # # # . . . . . . . . . . . # . . . . . . . . . # . . . . . . . # . # . . . . . # . . . . . . . . . . . . . # # # # # # # . . . . # # # # . . . # . . . # . . . . . # . . . . . . . # . # . . . # . # . . . # . #
# . # . # # # . # # # . # # # . # # # # # . # . # # # . # # # . . . . . . . # # # . # . # # # . # . # . # # # . # . # # # . # . # # # . . . # # # . . . # . # # # . # # # . # # # . # # # # # . # # # # # . # . # # # . # . # . # . # . # # # . # # # . # . # # # . # # # . # # # . # # # . . . # # #
# . # . # . # . # . . . # . # . # . . . . . # . # . # . # . # . . . . . . . . . . . # . . . # . . . # . . . . . # . # . . . # . . . . . . . . . # . # # # . . . # . . . # . . . # . . . . . # . # . . . . . # . . . . . # . # . # . # . . . # . . . # . # . . . . . # . . . . . . . . . . . . . . . #
# # # . # . # . # # # . # . # # # . # # # . # # # . # # # . # . . . . . # # # # # . # # # . # # # . # # # # # . # . # # # # # . . . # # # . . . # . . . # # # . # # # . # # # . # # # # # . # # # . . . . . # . # . # # # . # . # . # # # . # . # . # # # . # # # . # # # # # # # . # # # . # # # # #
# . # . # . # . . . # . . . . . . . # . # . . . . . . . . . # . . . . . # . . . # . . . # . . . # . . . . . # . . . . . . . . . . . # . # . . . . . . . . . . . . . # . . . # . # . . . # . . . . . . . . . # . # . # . # . # . # . . . # . # . # . . . . . # . # . . . . . . . # . # . . . # . . . #
# . # . # . # . # # # . # # # # # . # . # # # # # . # # # # # . # # # # # # # . # # # # # . # # # . # # # . # . # # # . # # # # # # # . # . . . # # # . # # # # # . # . # # # . # # # . # . # . # # # # # . # # # . # . # # # . # . # . # # # . # # # # # # # . # # # # # # # # # . # # # . # # # . #
# . # . . . # . # . . . . . # . # . # . . . . . # . . . # . # . # . . . . . # . . . . . . . # . . . # . # . # . # . # . # . . . . . . . # . . . # . . . # . . . # . # . # . . . . . . . # . # . . . . . # . . . . . # . . . . . . . # . . . . . . . . . . . . . # . . . . . . . . . . . # . . . # . #
# . # # # # # . # . # # # # # . # . # # # . # # # . # # # . # # # . # # # . # . # # # . # # # . . . # . # . # # # . # . # . # . # . # . # . # # # . # # # . # . # . # . # # # # # . # # # . # # # . # . # . . . . . # # # . # . # # # . # # # # # # # # # # # . # . # # # # # . # . # # # . # # # . #
# . . . . . . . # . # . . . . . # . . . . . . . . . # . . . . . . . # . # . # . . . . . # . . . . . # . # . . . . . # . # . # . # . # . # . # . . . # . . . # . # . # . . . # . # . # . . . . . # . # . # . . . . . . . # . # . # . . . # . # . . . . . . . # . # . # . . . . . # . # . # . # . . . #
# . # # # . # # # . # . # # # . # . # # # . # # # . # # # . # . # # # . # # # . # # # . # . # # # . # . # . # # # # # . # # # . # # # . # # # . # # # . # . # . # . # . # # # . # . # # # # # . # # # . # # # # # # # . # # # . # # # # # . # # # . # # # # # . # . # . # # # # # . # . # # # # # # #
# . # . # . # . . . # . # . # . # . . . # . # . # . . . # . # . # . . . . . . . # . # . # . # . # . # . . . . . . . . . . . # . . . . . . . . . # . # . . . # . # . # . # . . . # . . . . . # . . . . . . . . . . . # . . . . . . . . . # . . . # . . . . . . . # . # . # . . . . . . . . . . . . . #
# . # . # . # . # # # . # . # . # # # . # # # . # . # . # # # . # . # # # . # # # . # # # . # . # . # # # . # # # # # # # . # . # # # # # # # # # . # # # # # . # # # . # # # . # # # # # . # . # # # # # . # # # # # # # # # . # # # . # . # # # . # # # . # . # # # . # # # . # . # # # # # . # # #
# . # . # . # . # . . . . . # . . . # . . . . . # . # . . . . . # . # . # . # . # . . . . . . . # . . . # . # . . . . . # . # . # . # . . . . . . . . . . . . . . . . . . . # . . . . . # . # . # . # . . . # . . . . . . . # . # . # . # . . . . . # . # . # . . . . . . . # . # . # . . . # . # . #
# . # . # . # . # . # # # # # . # . # # # # # . # # # . # . # . # # # . # # # . # # # # # # # . # # # . # . # # # . # # # . # # # . # # # . # . . . . . # . # . # # # . # . # . # # # # # # # # # . # # # . # # # . # # # . # # # # # . # . # # # . # # # . # . # # # . # . . . # # # # # . # . # # #
# . # . # . # . # . # . . . # . # . . . . . # . # . # . # . # . . . # . . . . . . . . . . . . . . . . . # . . . # . . . . . # . . . # . . . . . . . . . # . . . . . . . # . # . . . . . . . # . . . # . . . . . . . . . # . # . . . # . # . # . # . # . # . # . # . . . # . . . . . . . . . # . # . #
# . # . # . # # # . # # # . # . # # # . # . # . # . # . # . # # # . # . # # # # # . # # # . # # # . # # # . . . # . # # # # # . # # # . # # # . . . # # # . # # # . # # # . # # # # # . # # # . . . # # # # # # # # # # # . # . # # # . # . # . # . # . # # # . # # # . # . # # # . # # # . # # # . #
# . # . # . . . . . . . . . # . . . # . # . # . # . # . # . . . . . # . # . . . # . . . # . # . . . # . . . . . # . # . . . . . # . . . # . # . . . # . . . # . # . # . . . . . . . . . . . . . . . . . . . . . . . . . . . # . . . . . # . # . # . # . . . . . . . . . # . . . . . # . # . # . . . #
# . # # # . # # # . # # # . # . # # # . # . # # # . # # # . # # # . # # # . . . # # # # # . # # # # # . . . . . # # # . . . . . # # # # # . # # # # # . # # # . # # # . # # # . # # # # # # # . . . . . # # # . # # # # # . # # # # # . # # # . # # # . # # # . # # # . # # # # # . # . # # # . # # #
# . # . . . # . . . # . . . . . . . . . # . # . . . . . . . . . . . . . . . # . # . # . . . . . # . # . # . # . # . . . # . . . # . # . . . # . . . . . # . # . . . # . . . # . . . # . . . . . . . . . # . # . # . # . # . # . # . # . . . . . # . . . # . # . . . . . # . # . . . # . # . . . # . #
# . # . # # # . # # # . # # # . # # # # # . # . # # # . # # # . . . . . . . # # # . # . # # # # # . # . # # # . # . # # # . # . # # # . . . # # # . . . # . # # # . # # # . # # # . # # # # # . # # # # # . # . # # # . # . # . # . # . # # # . # # # . # . # # # . # # # . # # # . # # # . . . # # #
# . . . . . # . # . # . # . # . # . . . # . # . . . . . . . # . # . . . . . . . . . . . . . . . . . . . . . . . . . . . . . . . . . . . . . . . . . . . # . . . . . . . # . . . # . # . . . # . . . . . # . # . . . # . # . # . . . # . . . . . . . # . . . # . # . # . . . . . # . . . . . . . # . #
# . # . # . # . . . # . # . # . # . . . # . # . # . . . # . # . # . . . . . . . # . # . # . # . # . # . . . . . . . . . . . # . . . . . . . . . # . # . . . # . # . # . # . . . # . . . . . # . . . . . . . . . . . # . . . . . . . . . # . . . # . . . . . . . # . # . # . . . . . . . . . . . . . #
# . # . # . # . # # # . # . # . # # # . # # # . # . # . # # # . # . # # # . # # # . # # # . # . # . # # # . # # # # # # # . # . # # # # # # # # # . # # # # # . # # # . # # # . # # # # # . # . # # # # # . # # # # # # # # # . # # # . # . # # # . # # # . # . # # # . # # # . # . # # # # # . # # #
# . # . # . # . # . . . . . # . . . # . . . . . # . # . . . . . # . # . # . # . # . . . . . . . # . . . # . # . . . . . # . # . # . # . . . . . . . . . . . . . . . . . . . # . . . . . # . # . # . # . . . # . . . . . . . # . # . # . # . . . . . # . # . # . . . . . . . # . # . # . . . # . # . #
# . # # # # # . # . # . # . # . # . # . # . # . # # # . # # # . # . # # # . # # # . . . # # # # # # # # # . # # # # # . # # # # # # # . # # # . . . . . # . . . . . # # # . # # # . # # # . # # # # # # # . # # # . # . # . # # # . # # # . # # # . # # # # # . # . # # # . # . # # # . # # # # # # #
# # # # # # # # # # # # # # # # # # # # # # # # # # # # # # # # # # # # # # # # # # # # # # # # # # # # # # # # # # # # # # # # # # # # # # # # # # # # # # # # # # # # # # # # # # # # # # # # # # # # # # # # # # # # # # # # # # # # # # # # # # # # # # # # # # # # # # # # # # # # # # # # # # #
# # # # # # # # # # # # # # # # # # # # # # # # # # # # # # # # # # # # # # # # # # # # # # # # # # # # # # # # # # # # # # # # # # # # # # # # # # # # # # # # # # # # # # # # # # # # # # # # # # # # # # # # # # # # # # # # # # # # # # # # # # # # # # # # # # # # # # # # # # # # # # # # # # #
