# # # # # # # # # # # # # # # # # # # # # # # # # # # #
# # # # # # # # # # # # # # # # # # # # # # # # # # # #
# 0 . . . . . . . . . . . . . . . . . . . . . . . . . #
# . # . . . . . . . . # . # # . # . # # # # # . . . . #
# . # . . # # . # # . # . . . . # . . . . . # . . # . #
# . . . . . . . . . . . . # # . . . # # # . # . . # . #
# . . # . # . # . # # # # . . # # . . . . . # . . # . #
# . . # . # . # . . . . . . . . . . . # . . . . . # . #
# . . # . . # . . . . . # # # # # # . # . # # # . # . #
# . . # . . . . # # # # . . . . . . . # . . . . . # . #
# . . # . . . . . . . . . . . # # # . # . # # # . . . #
# . . # # . # . # # # . # . # . . . . . . . . . . # # #
# . . . . # . . . . . . # . # . . # # # . # # # . . . #
# . . # # . . # # . . . . . . . . . . . . . . . # # . #
# . . . . . . . . . # # . # # # . # . . . . . . . . . #
# . . . . . . . . . . . . . . . . # . . . # # # # # . #
# . . . . . . . . . . . . . . . . # . . . . . . . . . #
# . . # # # # . # # # # # . # # . # . . . . . # # # . #
# . . . . . . . . . . . . . . . . . . . . . . . . . 1 #
# # # # # # # # # # # # # # # # # # # # # # # # # # # #
# # # # # # # # # # # # # # # # # # # # # # # # # # # #
